a	阿呵啊嗄腌吖錒锕
ai	瑷佁噯凒唉皧嘊挨躷嫒璦嗳僾瞹毐诶锿哀啀砹嬡曖埃娾蔼馤娭﨟餲伌騃鎄愛捱阨塧譺礙靄哎鱫碍暧靉藹皑敳鴱矮艾爱嗌昹薆壒鑀皚溰隘譪噫霭溾懓懝欸叆硋癌敱濭
an	馣广垵犴埯氨偣谙安闇鮟堓錌鹌諳铵媕痷貋鵪按侒峖桉銨葊鞌揞胺誝雸萻厂盦晻案蓭唵盫荌隌鶕玵婩韽屵罯豻俺菴暗黯腤庵洝岸儑啽鞍
ang	盎醠骯卬昂枊肮岇仰昻
ao	袄獓岙鏖謷璈鰲媼奡梎翱驁滶嶅隞翺擙夭澳媪襖嗷鼇嫯蔜奥熬敖墺坳嶴摮嗸芺奧抝謸懊镺岰廒骜嚣慠垇遨螯獒聱鳌艹軪鷔拗澚傲爊凹磝鏊柪翶厫
ba	鮁扷跁霸柭抜鈀八疤捌蚆妭伯叐胈爸垻壩魃羓覇罢癹芭耙靶罷杷茇欛叭拔哵粑鼥菝朳夿詙鲅把吧矲軷炦巴仈豝釟笆丷弝跋颰坝钯鲃灞岜玐
bai	猈犤柏稗襬伯粨百陌栢白拜呗竡败庍贁佰韛絔摆掰擺拝挀敗粺薭捭
ban	舨辬秚怑癍鳻瓣魬螁岅伴搬扳版般绊扮頒昄肦办攽颁半斑斒鉡靽柈瓪螌坂钣坢板褩鈑粄阪瘢姅辦闆絆拌班蝂湴
bang	梆磅邦幇傍幚綁搒挷浜谤蜯謗帮镑蚌棒绑牓玤塝邫艕稖捠鞤縍幫鎊棓蒡垹旁榜膀
bao	寚菢儤苞曝賲珤包堢飹闁宝勹媬雹饱襃靌髱鑤報宲窇鳵鸨孢鴇葆笣剥炮刨剝佨胞保藵怉瀑堡趵寳寶勽駂鉋骲曓煲爆蚫褓暴抱緥齙褒豹枹报飽铇虣犦袌鮑龅薄忁裦蕔鲍
bei	犕偝愂禙背僃軰辈臂苝揹鋇焙椑輩惫备贝倍碚桮藣邶褙骳卑俻誖蛽陂牬郥被呗梖杯碑憊備昁鄁柸鹎悖鞴狈鵯唄孛鉳钡鞁悲盃偹鐾棓珼貝糒琲狽蓓北
ben	笨泍奔渀贲錛桳楍夯翉撪逩坌捹锛本奙畚倴苯犇
beng	逬甮甏崩奟鞛泵菶祊綳蚌繃閍琫塴琣镚揼鏰甭迸嵭绷埄痭絣嘣伻蹦埲
bi	俾偪蓽萆髲鰏珌睥蹕詖綼贲鼻鎞迊鼊毴鲾辟鷩毙梐畁躄庳煏鏎陛鵖鐴沘碧诐闭彃蓖妣斃秕弼畀韠粊坒婢閟痹閉弻毞庇鄪楅縪夶必佊毕怭邲螕躃滗朇愎觱笓苾豍聛駜廦驆畢铋赑箅贔咇吡滭币皀皕繴幣荜榌避篳髀賁飶睤貱臂壁魓荸跸獘薜腷朼粃篦鉍蔽屄彼裨堛萞佖柀怶逼嬖狴襣濞妼罼疕哔貏鮅泌閇潷敝毖箆璧匕笔襅痺襞蜌奰舭鄙秘愊鷝箄嬶熚筆弊芘筚袐饆柲馝鄨啚湢禆嗶比鞸疪幤獙
bian	甂糄砭苄変緶贬缏碥峅箯牑辫覍鴘卞编边鞭昪蝙便徧辩揙煸弁鳊抃諚獱邊遍釆玣辮鞕萹鯿稨藊笾變扁鯾閞辡惼辯辨邉編忭褊猵貶炞籩变鍽窆艑汳匾汴辧
biao	鏢穮彪猋膘镳磦骠麃飈蔈熛臕髟儦謤颷爂瀌標嫑瘭飇滮俵标摽檦婊鋲表藨幖驫颮骉飊錶諘杓脿褾墂贆裱鳔镖飑淲飚飙飆鑣
bie	憋鱉别龞蛂襒莂癟別鼈蹩虌鳖彆徶蟞瘪
bin	濱霦梹彬臏豳椕玢鑌賓髕瀕傧殯缤賔蠙髩殡頻璸繽顮儐鬢鬂摈髌宾邠瑸擯镔濵斌虨檳膑鬓滨豩槟濒
bing	栟鞞並绠倂寎竝鉼庰靐丙垪饼仌邴稟餅昺栤陃昞偋棅屏摒眪炳苪掤窉併柄幷病鮩鈵抦蛃禀冫鞆兵冰怲秉誁氷傡槟餠并
bo	襮紴肑郣譒蔔伯舶蘗魄鈸脖嚗瓟般袹鮊癷僠馎狛餺侼啵驳渤糪髆铂波箔鎛鑮袰愽玻膊蕃礡挬淿煿秡孹癶盋碆僰馛泊餑簙钹博缽鲅袯礴鵓牔欂帛驋柏襏檗萡鋍髉撥胉鹁剥亳跛蹳趵砵擘播孛葧饽踣猼鲌鉢駁菠謈镈仢駮懪嶓艊拨钵勃搏鉑卜鱍簸浡馞瓝薄哱溊
bu	踄补餢郶勏峬鵏哺柨鈈吥廍誧鳪晡餔布簿錻捗鸔不轐歨怖堡醭咘篰埠埗瓿逋佈歩荹捕蔀钸卜部钚鈽步埔補庯悑巭卟
ca	礤礸擦遪嚓拆攃
cai	毝綵縩蔡猜寀婇跴棌裁踩彩採偲啋菜采倸宷埰財材纔睬财才
can	傪朁慙驂澯湌黲慘黪掺蠺憯篸惭飡儏璨穇燦粲蚕残參餐孱叄骖謲蠶爘惨慚嬠薒蝅叅喰殘灿参
cang	藏沧嵢臧蒼濸仓鑶螥鸧獊倉凔傖仺舱苍鶬艙滄賶伧
cao	糙蓸襙草鼜操撡螬褿曺騲艚懆鄵曹鏪槽愺漕肏慒嘈艸嶆
ce	箣萴蓛侧萗廁夨測厕冊恻粣拺笧敇側憡厠簎荝筴筞策惻测册
cen	涔梣嵾笒岑埁参
ceng	竲層层嶒曾噌蹭驓
cha	檫鍤衩揷餷楂诧偛艖侘杈喳扱差奼插汊嵖秅咤査叉詧槎镲扠鑔臿挿蹅岔剎茬碴銟馇茶搽靫嗏紁詫姹察垞猹疀刹查嚓锸
chai	訍喍犲侪肞虿钗釵袃祡蠆瘥豺柴囆芆茝拆差儕
chan	潹禅誗艬讇纒潺婵顫廛忏摌缠梴硟斺懺蝉羼鏟躔骣觇闡僝浐旵磛蟾摻蟬颤覘剗丳裧儃產劖嚵欃酁刬瀍苂燀儳瀺纏谗产蕆滻毚獑幝鑱讒閳辿醦巉襜湹蒇冁剷壥搀谄譂諂掺緾繟幨煘棎簅囅螹饞産懴摲孱灛镵攙单澶嬋鋋阐馋鋓鄽铲韂
chang	苌瓺仩淐鱨伥裮瑺琩腸敞昌償鯧長畅嫦氅閶怅长椙倘尝昶鬯悵畼娼誯镸錩场玚兏鲿鼚暢厂鲳仧厰嘗偿菖鋹焻萇蟐锠裳倡場唱常惝廠倀甞塲韔僘阊膓肠徜嚐猖
chao	罺牊麨绰鼂漅巐巢炒煼觘吵訬仦超潮鼌巣朝耖怊謿晁仯鄛樔焣窼剿欩抄弨窲嘲鈔焯眧钞轈
che	頙撦尺蛼瞮掣偖车撤爡伡坼砗唓硨澈扯硩聅車徹烢屮迠莗彻勶俥
chen	陳捵棽衬儭夦辰瞋諶忱沉嗔郴塵讖抻莀晨尘墋趁螴齔栕琛烥谶踸臣磣瘎煁薼鷐碜莐敐櫬龀嚫麎賝謓軙趻鍖諃谌齓宸迧敶陈樄曟贂榇襯硶茞蔯訦愖疢霃称趂桭綝伧鈂
cheng	程成牚絾懲峸侱緽脭筬悜頳庱蟶瀓枨窚珹秤檉檙樘爯塍噌泟荿竀赬赪鯎阷塖稱骋棦乘偁鏿呈澂称埕掁酲畻洆溗挰柽盛惩誠撑饓揨珵娍撐晿浾睈铖朾鐣憕橕碀摚澄宬椉铛棖琤诚堘橙城蛏靗瞠憆裎郕承鋮騬騁罉徎丞乗穪逞
chi	垑恥螭褫篪喫痴鸱媸瓻謘敕熾翨誺胣遫鷘欼摛瘈妛鉹眵貾竾蚇豉墀赤彳筂炽伬袲憏斥恜訵迡歯湁殦遟驰嗤袳勑癡雴赿池侈黐漦叺傺瘛卶叱麶饬翄弛荎鴟迟馳杘侙彲蚩瞝鍉坻彨絺胵飭灻痸懘翤烾翅魑尺遲抶粚慗茌趩呎哧遅箎持噄齝笞勅鵄啻吃蚳踟齒銐鉓鶒匙肔齿裭耻腟攡
chong	緟冲憃崈宠舂艟漴寵忡浺埫充铳憧摏隀罿种崇茺褈衝銃珫揰沖蝩翀蹖重嘃爞涌蟲虫
chou	燽雠酧踌紬愁臭雔儔丒讐惆偢鮘绸醜畴雦皗瘳懤矁籌抽俦吜疇搊篘魗醻杻嬦裯讎犫瞅檮犨菗栦絒殠臰丑稠躊椆綢帱遚杽筹詶薵仇幬酬
chu	禇処榋岀竌齣畜础礎鉏泏樗璴滀儊齼芻傗绌鄐豠楚雏黜珿储儲濋蹰搐廚橱蟵褚矗蒢篨嘼櫥憷躕埱欪初斶蜍敊歜鋤諔觸媰櫉檚臅摴滁蒭触出除竐杵雛亍处貙楮趎幮豖厨刍耡犓俶怵齭處椘閦絀助锄鶵躇
chua	欻
chuai	膪揣踹搋膗啜嘬
chuan	椽篅氚舩暷歂踳传猭喘穿汌舡串玔船剶瑏巛鶨釧遄賗輲荈川舛傳僢钏
chuang	闯牀窻摐怆傸牕闖剏愴疮剙幢创床創刅磢刱窓窗瘡牎噇
chui	埀锤腄龡菙陲炊圌顀箠垂鎚椎搥吹棰桘槌捶倕錘
chun	纯蝽惷鹑槆犉醕瑃脣睶櫄滣春媋橁蒓鶞萶陙漘萅箺錞堾鰆賰輴浱鯙醇鶉湻椿杶莼偆旾暙淳蓴唇蠢純
chuo	鑡婼龊嚽绰戳辶趠娖踀娕哾涰酫啜綽婥歠餟惙齪擉繛辍逴輟辵磭踔
ci	佌糍鮆茈鷀此蛓雌濨词縒飺差礠磁辝朿柌莿辭髊茦珁疵泚鴜薋赐辤鶿趀蠀垐嬨賜玼呲骴鹚餈茨刾慈皉伺辞次絘甆兹刺佽栨螆庛詞瓷齹祠偨跐
cong	聦騘忩錝鏓棇琮賩繱欉聰骢璁爜謥悰鍯誴樷潨暰熜蓯憁匆樅蟌驄聡丛聪苁瞛瑽潀葱枞怱囱従叢賨蔥婃鏦篵孮樬從漎悤徖淙愡囪徔楤茐藂漗从灇
cou	凑湊辏楱腠輳
cu	蔟誎橻噈觕卒瘄猝蹙踿麤顣麄瘯憱殂怚粗簇醋徂蹴酢脨麁鼀促趣媨踧縬趗蹵
cuan	熶簒躥菆篡鑹竄櫕殩穳镩窜攒巑蹿爨欑撺攛汆
cui	綷淬槯襊墔紣悴竁倅璀疩焠伜翆粹脃毳獕琗縗崔顇翠慛磪萃膬鏙啐漼凗啛嵟濢粋脆缞脺瘁趡榱臎催忰膵摧皠
cun	村邨蹲澊膥竴籿踆皴刌寸侟拵存忖墫
cuo	瑳逪措蓌矬错嵳銼醝痤瘥鎈剒蒫莡鹺剉搓挫睉厝脞撮蹉莝夎锉遳虘鹾錯蔖磋酂嵯
da	畗墶畣呾大塔瘩韃炟惮汏笪眔笚打達噠撘龖鎉薘迚逹搭答跶怛詚亣耷靼匒蟽躂龘疸咑沓剳荙迏羍繨褡垯鎝哒达鐽迖荅鞑嗒妲
dai	帯廗襶叇帒貣大軩紿呆靆贷鴏瀻骀侢迨軑垈黱戴黛獃軚绐殆袋柋跢霴傣带瑇呔懛待緿艜甙埭曃帶蝳怠歹逮岱簤貸玳代轪歺蚮
dan	勯瓭疍沊澹惮衴饏亶餤誕啿耼簞黕聸蛋但殚媅柦癚酖担禫窞擔匰掸馾髧丹躭砃氮鴠箪駳唌蓞鄲繵蜑刐紞嚪嘾帎眈诞玬賧噉萏郸憚弹耽觛頕抌淡襌憺赕甔膽腅旦啗妉石殫啖彈褝黵泹弾単撢聃儋僤單癉伔瘅狚撣胆霮疸单黮贉
dang	檔瞊当蟷攩擋壋蕩噹荡雼铛儅璫档蘯珰砀黨譡挡瓽礑垱逿菪闣艡盪襠簹愓碭筜讜党鐺氹趤谠圵凼婸宕璗潒當裆澢欓嵣簜灙
dao	燾﨩忉翢翿菿祷衟椡捯禂導捣盜道陦壔擣噵导隯舠稲刂衜鱽稻焘瓙悼嶋岛釖螩纛搗禱到朷叨嶌刀氘魛島盗蹈帱槝辺艔倒檤隝嶹軇
de	锝的德得底鍀棏恴嘚淂悳惪地徳
dei	得嘚
den	扥扽
deng	蹬镫簦嶝瞪璒噔戥邓鄧磴墱澄僜嬁覴艠等燈隥登竳櫈鐙凳灯豋
di	阺敌樀覿馰掋唙俤骶的仾苐啇提鏑偙敵羝地墑岻蔋递奃揥笛觝隄甋腣旳埞菧抵嚁堤苖镝廸豴迪媂杕蒂荻磾第蝃柢呧砥娣狄藡拞遞嶳诋棣踶楴趆頔碲螮摕底祶埅墬氐蝭玓帝牴聜睇慸秪焍袛嘀鉪梊坔怟彽糴坘厎遰坻低珶詆滴觌缔蹢締啲逓釱鞮眱涤僀滌鸐嫡邸弟蔕梑弤枤靮髢菂谛軧埊諦蔐翟禘鯳籴
dia	嗲
dian	齻颠椣橂典碘坫婝点磹掂敁癜蜔蕇顛槙滇巔垫钿蒧奠蹎巅癲電槇惦殿巓扂嵮顚敟澱踮婰甸墊點癫攧奌电阽壂店玷傎厧瘨淀驔鈿琔靛簟佃
diao	鳭铫鑃盄鮉雕釣凋蓧掉銚窵錭弔弴钓汈鵰叼奝鯛蛁屌鋽貂調魡调虭刁窎伄訋琱藋铞銱吊鲷瞗彫竨碉鼦扚鸟簓鈟瘹刟雿
die	挕揲鲽艓褺迭苵垤褋疊蜨幉峌眰喋昳惵耋牒趃殜谍碟蹛鴩疂绖螲蝶鰈臷曡眣詄跕疉楪蹀耊氎戜跮咥恎畳牃胅跌爹嵽叠镻哋堞瓞絰諜
ding	虰忊萣奵薡釘碠饤铤顶町仃嵿碇疔艼靪酊锭帄飣丁椗钉矴叮订啶定腚玎顁耵頂鼑濎磸盯錠訂鐤鼎
diu	铥丢銩丟颩
dong	咚鯟岽蕫湩冬氡垌姛董鶇蝀嬞硐娻涷冻諌駧峒懂昸侗棟働挏胴笗崬迵苳動箽腖埬鼕东鶫崠菄胨霘栋戙氭凍東动鸫倲洞鮗恫
dou	抖痘闘枓唗荳毭乧逗酘竇蔸梪鬦郖豆斣唞橷饾蚪鬥閗斗鈄都读鬭兠窦阧脰鬪餖篼鬬渎剅吺钭兜吋陡浢
du	秺阇笃牍黩杜韣髑瓄犢凟琽芏殬賭櫝牘讀裻鑟韇睹蠧蠹豄犊肚讟匵靯皾都醏读荰鍍毒独殰督嬻篤椟剢錖獨贕渎瀆堵赌渡嘟闍度螙妒镀韥覩黷妬騳厾斁読
duan	碫段躖鍴緞塅鍛腶葮媏椴缎锻籪簖断斷端褍偳毈短煅瑖耑
dui	碓鐜對堆镦懟兌瀩鴭頧憞对敦綐譵鐓錞祋憝濧対垖痽怼譈兑轛薱塠兊队陮磓隊
dun	燉盹砘遁潡噸犜沌礅炖踲壿遯庉蹲墪驐敦鈍囤吨蹾惇逇钝碷伅頓趸蜳撴躉盾顿撉楯镦墩
duo	凙綞鵽鈬墮舵沲垜垛堕杕饳敪椯鬌埵喥﨣踱剁缍躲夺亸奪挆躱哚毲跥痥趓嚉哆裰陏多剫惰跺尮澤咄鐸朶媠驮陊挅敚夛軃嚲度柂敓朵铎柮崜桗墯掇刴敠剟憜奲飿
e	颚蚅櫮磀咢訛歞愕諤岋锇悪恶齶额顎礘珴讍枙砨鹅鹗垩額噁軶萼誐腭譌頞鶚偔讹廅遻搹鵈閼卾锷妿鵝扼阿戹鑩峨蛾皒遌湂蝁遏鈪軛鄂鵞迗鍔豟鰐哦妸涐騀咹睋鱷轭屙饿惡峉砐齃鈋鰪俄魤娥吪囮擜堊噩匎呝砈苊崿姶搤頋鋨僫婀餓餩莪琧阏胺谔頟阸娿鳄堨堮峩覨蕚硆厄呃
ei	欸誒
en	煾峎恩蒽奀摁
eng	鞥
er	侕轜刵薾鲕誀袻乻铒弍珥弐栭荋衈尒峏餌樲饵隭迩鮞鸸輀耳趰胹駬髶粫毦貳児尓佴貮臑二唲洱尔陑耏鉺爾洏而髵邇咡聏儿栮鴯贰
fa	伐罰筏瞂垡灋坺疺彂傠峜酦冹阀浌髪墢佱姂藅罚橃琺蕟法鍅砝珐髮发栰乏發閥笩罸茷沷発
fan	軓颿籵樊膰反帆钒鐇返蕃棥笵梵鱕仮瀪礬輽嬎矾範飯凣蘩襎旙盕柉煩蠜繁釩嬏烦勫汎舧畈販払幡舤飰番薠訉滼奿燔轓墦瀿饭泛笲贩繙藩杋匥緐范旛鷭忛飜籓凢璠羳蹯憣橎畨犯氾軬袢噃翻凡
fang	枋房昉防纺倣錺鈁趽紡彷放堏钫肪坊芳访鴋旊匚淓妨蚄昘仿訪瓬眆髣舫邡鲂汸鶭方牥魴
fei	蜚馡吠猆俷緋蜰廃悱曊費萉婓渄痱扉婔誹疿鼣翡暃费蟦奜怫屝肺匪胐榧沸淝飞镄櫠肥腓昲騑鐨飝濷靅靟騛斐菲鲱诽篚陫发废非廢棐霏飛妃蕜鯡啡裶芾朏杮绯胇餥狒厞癈剕
fen	蒶奋竕羵墳分瀵吩汾鼢炃馚獖濆玢燓橨鐼忿秎粪昐豶轒朌鼖蕡坟帉妢糞鱝酚餴奮棻纷鈖芬黂份弅隫訜躮偾焚燌棼鲼黺紛僨憤氛瞓朆豮饙蚠膹衯馩岎蚡粉魵羒幩愤翂坋梤雰枌
feng	鋒鏠锋煈賵凤風碸僼仹灃枫烽蜂妦寷酆丰鳳溄豐檒焨凨盽奉赗鴌凬堼冯琒桻封飌葑峰峯崶浲缝瘋摓縫覂漨艂凮鎽麷馮諷夆砜湗綘沣犎风猦蘴堸疯俸蠭鳯渢沨楓篈鄷唪靊逢讽偑
fo	佛坲梻仏
fou	妚雬殕缻缶否缹紑鴀
fu	峊賦罘泭韍嘸詂幞麸祔邞畐虙麩褔复祓蕧甶妋蚨絥鮲匐諨绋澓箙咐婏冨夫覄麱偩孵稪驸阜脯颫枹附酜呋筟芙蝮蝜芾鍑佛辅孚馥翇甫襥艴斧妇綒玸付懯鉜拂鬴韨乀柎赋哹腹賻阝旉琈彿鉘抚弣復紨俌鵩鳺垘洑鮒秿禣扶玞敷绂負烰縛姇焤柫艀蝠父緮﨓岪鶝媍凫衭鳬幅鮄紼盙俯婦棴豧弗滏粰伕訃肤符富糐踾麬坿赴萯砆砩跗癁缚鳆赙芣伏莩黻怫頫鳧栿荂巿覆罦蜅胕鲋駙鍢袝副蚹刜涪紱辐菔茀黼讣蚥髴茯釜郙捬鈇釡桴笰綍鰒炥複趺袱輔郛蛗怤稃服襆荴袚鄜咈枎腑輻竎膚拊撫负俘椨福帗娐榑苻鴔葍腐椱尃俛簠蜉氟畉府傅嬔輹浮
ga	尬伽噶旮尕錷釓魀咖呷尜轧玍钆夹嘠嘎
gai	郂赅戤侅摡蓋祴絠匄該溉葢匃钙豥荄乢瓂陔隑改賅鈣姟畡概槩漑该盖忋賌芥垓絯晐丐峐槪
gan	忓皯鱤贛仠芉秆杆桿肝詌鳱迀坩橄盰幹赶簳灨攼粓衦骭凎酐竿旰澸鳡矸甘绀疳姏赣泔感凲漧尲擀敢魐笴筸尷苷汵贑稈玕淦檊趕紺干榦倝奸澉柑尶尴
gang	冈肛槓戆岡罁釭疘杠冮戅罡綱港犅岗纲摃焵鎠缸堽鋼刚扛焹戇掆矼崗棡堈钢剛筻牨
gao	菒鷱鼛锆暠夰缟縞鷎檺皐吿郜鋯羔餻鎬镐皋祮藳稿臯膏稁稾韟髙高槔告杲筶禞槁藁誥搞峼祰羙槹篙槀勂糕櫜诰睾橰
ge	佮轕滆膈戈牫敋嗝鞈革閣槅骼個阁格戓閤葛隔圪仡戨鴿謌镉各呄鉻肐犵彁纥鎶愅獦割諽鎘扢胳塥觡匌茖袼滒嗰挌櫊咯鴚韐輵韚搁虼哥蛒鞷硌箇鬲饹盖蛤合哿臵个鸽騔铬裓搿歌鮯舸擱疙
gei	给給
gen	跟亙根茛搄亘揯哏艮
geng	賡畊绠耕刯絚鹒鯁耿更暅赓埂焿椩堩浭縆緪挭綆郠菮梗峺哽庚骾鲠莄颈鶊羮羹
gong	攻嗊貢厷弓拲贡躳龔工躬共塨熕功宮杛愩恭巩鞏幊觥蚣赣慐廾肱碽宫輁龚唝侊觵珙红供匑拱匔栱糼龏公髸汞糿
gou	耈煹冓鈎勾韝緱褠觏狗購芶购耉姤笱簼苟岣够雊彀佝啂痀诟鉤垢覯构鞲搆豿缑钩玽坸媾蚼撀耇句夠訽詬枸篝遘構沟溝袧
gu	詁贾篐馉嘏淈鹘苦棝錮唂蓇呱箛估崮牿蛄锢鼔毂顧箍杚鸪夃軱愲辜汩泒股顾鯝鮕咕鈲軲钴鈷逧古轱沽榾鹄榖皼餶唃笟蠱罟瀔觚嗀嫴鲴鶻故橭家穀堌牯臌菰诂鼓菇柧盬酤罛谷傦僱梏皷脵薣姑雇瞽祻尳骨固稒痼鴣蛊縎濲羖轂孤崓苽糓啒凅
gua	詿劀胍煱罣剐踻颳趏剮歄騧呱叧緺鴰掛刮诖鸹啩褂颪桰卦栝冎寡坬挂絓瓜
guai	罫枴叏怪乖恠夬摑拐箉柺
guan	馆管関貫倌鸛涫關覌琯璭鳤礶关樌罐观纶冠潅遦盥掼矜雚鹳鱹泴官錧矔毌蒄観串悺悹館摜丱棺鑵窤輨瓘觀鰥瘝卝慣灌鏆莞筦鱞癏舘祼痯欟罆躀爟贯鳏惯闗
guang	黆灮广烡犷光輄銧炛炗廣獷臦俇珖洸広臩姯咣炚逛桄垙]胱茪僙
gui	嬀槼蓕鐀癸瞡闺櫃厬摫鬼规櫷庋昋胿媯帰贵匦劌軌攰跪皈撌檜蟡轨襘龟鑎璝诡龜炅閨椢禬郌庪恑茥規亀攱桂騩瑰湀妫刿鱖硅筀陒雟猤宄劊觤袿鬶嶲簋蛫鞼槶槻炔歸詭归匭嫢鳜垝鬹瞆鱥癐桧祪刽蘬鲑螝柜邽廆瓌佹珪圭氿貴椝鮭樻姽晷瞶
gun	鲧緷蓘滚緄睔鮌滾磙謴棍惃丨鯀蔉袞绲衮輥辊
guo	猓咶锅囶楇槨腘圀聒綶嘓椁濄鐹簂掴果幗涡聝慖国过虢惈蜾鍋崞馘淉裹啯呙囯過埚輠彉膕郭堝懖國鈛粿漍帼褁瘑囻蔮蟈馃彍餜腂蝈菓墎
ha	奤呵紦哈鉿虾铪蛤
hai	海餀饚骸駭嗨骇妎塰害醢孩酼嗐氦亥咍胲駴还烸咳
haixun	浔
han	厈蚶焓屽瀚漢菡韩蜭顸函嫨娢崡梒汗睅暵魽旱駻琀爳浫凾虷憨垾顄邯鼾鶾哻甝悍捍酣雗韓銲譀筨撖浛晘犴螒翰唅颔喊蛿蔊晗扞釬豃傼蜬憾感閈涵猂闬罕兯圅鋎焊熯頇佄汉嵅澏寒皔馠谽邗涆莟馯鋡頷含撼
hang	炕筕吭蚢杭笐苀魧斻颃迒航夯絎貥珩裄行巷頏沆肮绗垳桁
hao	滈淏蒿嚆毫籇嗥獔蠔皞獆壕侴暤灝灏乚澔獋镐皋郝号鄗聕顥茠噑哠颢蚝恏好昊暭皡竓譹嚎濠皓椃儫號皥薧豪秏皜傐薃曍嘷鰝昦悎耗晧薅貉浩毜
he	河吓燺袔訸頜螛鹤餲郃翮阖嗃猲曷呵姀惒澕柇佫哬焃鑉咊龢貉盍褐赫賀渮啝訶楁涸爀鲄盒盉抲纥贺餄煂篕颌鶮熆鸖鹄麧荷龁寉核嗬翯鞨靍釛蠚劾嚇敆闔鶡萂垎謞鹖鶴粭碋毼菏魺和欱饸熇合诃皬靎禾狢籺阂盇鉌礉害峆壑齕紇癋詥喝靏貈覈何閡牙合
hei	黑潶黒嗨嘿
hen	拫很哏詪佷狠鞎恨痕
heng	姮胻涥鵆哼亨蘅恒珩行啈撗脝衡烆鴴恆横鸻橫悙鑅桁
hong	紭仜粠篊屸沗霟讧紘晎耾呍撔嚝谼哄泓叿黉焢澒葒葓翃渹荭闳硡硔鍧鬨薨唝闂渱汯洪彋揈纮訌轟谹虹紅鸿閎魟吽垬弘鉷竤霐輷妅銾訇竑綋鴻玜軣吰轰烘潂灴蕻羾翝黌玒娂鈜鞃鋐闀宖浤閧红谾宏苰
hou	矦銗洉瘊齁鮜厚帿翭鍭犼篌逅豞葔糇睺堠餱候侯後吼鱟郈垕鯸鲎鄇翵茩骺鲘猴喉后
hu	鹘粐虖胡錿沍泘沪鍸隺滸互葫歑瑚嫮俿怘鍙瀫芐鶘虝乕曶苸謼糊弧壶狐忽鬍婟槲楛頶浒帍囫乎綔鸌滹滬護頀媩虎匫琥絗雽瓠軤鹄雐縠戸核烀壺汻祜护槴戽瓳煳嗀鹕抇壷呼嘝冱扈嗀鯱轷螜芴魱蝴戶虍幠笏昒惚唿焀摢垀恗和嚛昈鳸簄唬戏嫭醐怙餬匢雇熩鹱鳠鱯搰膴蔰猢岵湖鰗寣萀豰箶鵠弖枑户淴鶦鄠斛觳喖楜蔛衚嘑
hua	哗糀画黊誮滑畫杹蕐嘩畵呚婲錵磆蒊猾砉觟嫿鲑譁樺嬅椛鋘硴鷨婳骅铧摦蘤澅諣撶舙話桦繣螖譮諙划驊釫搳華釪鏵槬埖枠话化夻劃姡崋花华
huai	淮划踝蘾褢怀瀤壊坏褱徊懐櫰耲槐懷壞蘹
huan	浣豲睆煥郇糫逭渙獂犿鬟歓锾缓喛鐶梙歡鍰闤烉漶鹮堚繯環洹萑嚾緩瑍嵈峘攌讙奐孉眩欢貆澣藧瓛肒獾酄鲩狟貛涣還鴅豢鰀嬛患焕寰寏阛愌轘喚幻鯶萈槵宦换瘓桓綄絙換圜唤痪镮澴缳鯇鵍环擐荁奂懽还羦雈驩
huang	巟蟥滉崲鷬黃黄艎瑝穔簧獚熿癀媓璜慌朚遑騜奛縨皝徨宺惶趪晃謊鱑楻愰蝗鎤皇諻榥鳇喤潢偟葟鐄曂幌餭揘墴韹怳隍肓堭锽恍鍠篁塃磺荒兤湟谎櫎凰熀鰉煌炾衁詤晄皩
hui	烣缋睢頮揮獩儶隳詼堕瞺櫘僡迴诙哕逥茴囘瘣顪璯挥隓悔泋詯鐬蔧颒婎毁绘秽灳烩徽虫誨蜖蟪橞懳蛕洄嚖濊嘒汇薉毀晦徻睳槥鰴痐翬豗慧撝諱珲譭嬒廻咴恚蘳翚蛔寭虺诲鮰恛蕙讳佪潓屷湏輝麾恢会囬灰芔贿繢闠瀈匯蚘惠恵拻戏噅憓洃屶暉袆彗幑卉楎彙禈賄廽藱會晖燬圚翽譓繪浍翙桧鏸褘檓媈煇暳絵滙廆彚回靧檅篲喙烠餯燴璤穢炜薈噕荟毇阓譿辉
hun	葷慁忶掍尡睯混浑睧焝昬阍睴餛蔒溷閽渾荤倱諢俒婫珲鼲觨棔琿涽婚轋惛圂魂馄诨殙昏
huo	捇眓劐邩貨窢雘癨耯艧奯嚄咟吙濩嚯攉惑夥秴豁货喐旤獲謋瀖嚿曤蒦锪或霍韄剨钬靃灬祸沎鍃活秳镬彟蠖彠閄煷和获矆俰禍穫擭掝鈥漷湱臛檴耠秮鑊矐伙藿火騞佸
ji	嚌檵嵴檕革伋洎堲愱哜穊劑嶯曁吉癪卙殛蝍廭鰿嗘槉毄藉机羇妓魝庴犄懻簊濈嵆驥荠稷楫圾觙漈隮觊刏畸齏稩罽芨急偮輯譏銡迹蒺積雧记屐肌機蕀齎挤揤績蕺磯螏禨暩鸄齌瀱寂激箕幾鐖及鍓彶刉鬾鑇忌臮跡虮骥叽踑虀躋脊姬緝偈冀济湒乩緁塉坖郆旡给魕茍璾焏觭嘰籍丮磼佶撠諅鶏畟矶朞極嵇掎霁踖瘠稽紒撃旣諆勣鰶级击跽蔇几艥覬辑鯚皍裚櫅麂繋忣紀耭茤僟槣汲蘎戟鳮濟犱叝稘即岌銈済笈際其棘雞擊鯽級樭記薊膌计蹐譤疾霽鑙悸季玑唧蹟韲芰蓟讥賷穖魥繼鷑躤鲫跻寄羈系檝璣鶺泲基剤蘮漃鱀筓亽葪伎妀赍剞既枅鏶技卽缉梞彑祭惎継穄楖饑亟垍暨纪蟣戢集趌髻覊霵計饥畿鱾﨤魢襀橶擠际痵鱭鸡鞿墼嫉襋己齐禝羁綨覉绩錤笄鲚穧耤积蘻继飢极潗誋轚薺鷄鹡齑剂咭奇箿喞亼徛兾谻姞鵋癠躸
jia	价贾嘏價莢稼幏槚耞铗裌鴶檟珈夹圿脥佳榢傢豭玾椵唊甲颊鉫徦郏頬駕跲斝忦婽浃斚戛鵊迦枷拁抸笳糘岬伽戞犌鉀賈嫁貑夾郟鎵鴐扴家榎梜痂架跏鋏胛蛱猳頰浹加茄麚腵钾泇驾叚蛺瘕假恝嘉镓毠荚葭袈筴
jian	墹猏搛鹻諓缄缣剣檻殲裥瑐珔豣譛槛兼趝箭鞯礀鵑帴笕撿鶼蠒簡蹇践踐旔湕檢袸篯鰎鐱谫荐鵳健瀽奸碊幵鍵礷劒鍳俴瀐瀸漸饯揀豜検涧榗籛礆濺鑳鐗澗艰劍儉键僭锏鑑減翦韀彅鋻鑯鰔煎睷雃薦藆椾覵熞寋笺菺拣枧艱鑒襉蕳麉韉趼惤艦殱碱冿蔪鬋剑鳒洊舰肩渐詃熸謭臶繭姧件諫鹸瀳襺椷溅建戔襇鏩謇牮梘腱虃犍俭挸繝玪鰜間縑踺絸贱葌櫼栫跈劎轞简戋緘鹣监揃戬筧剱磵姦徤浅箋監鑬蕑馢蒹瞼礛擶暕茧瞷覸检瑊譼睑糋歼鹼楗餰间鞬捡譾弿菅見鰹尖堿谏餞堅囝剪湔鲣鳽柬坚賤鐧鉴賎见囏劔戩倹牋硷樫减毽
jiang	疅糨摾蔣櫤滰獎姜强鱂鳉繮奬糡蒋畺将弜犟嵹僵礓膙橿缰螿夅酱葁匠桨壃疆江殭講匞洚耩奖弶將槳翞浆畕漿傋塂茳韁摪顜螀奨绛讲謽勥醤降薑豇絳醬
jiao	撟僥交鱎滘矯挍窌鷮簥勦敿跤賋藠徺礁矫窖鹪劋憍斠筊絞虠噭釂茭狡鵁蕉鉸烄摷珓灚趭佼脚挢嶠侥徼较撹較潐鷦椒嶣剿攪呌孂校绞酵獥敽譥醮鐎缴煍訆璬敫鲛艽嬌郊敎湫浇龣儌嬓笅蛟茮穚胶轿皭峧叫膠膲觉嘦譑噍焦澆驕皦峤暞铰餃捁角皎教轇嶕娇曒踋繳饺晈姣憿僬臫鮫蟜骄嚼搅漖轎嘄蟭嘂腳
jie	楶价堦魪疥岕阶桔楷庎衸颉擮鶛藉滐犗丯桝蠘嗟杰刼掶鲒洁蠞喈碣借絜刧誱解檞届秸楬界蝔鍻榤嵥頡鞂鎅褯偼傑揭訐蜐劫狤羯偈搩拮鉣结尐徣稭畍莭礍楐鞊桀喼堺街結謯脻芥巀痎睫镼截杢飷琾皆掲鮚节唶媫媎孑婕蠽癤嫅家節觧湝擑菨袺介悈潔岊讦竭踕煯接衱屆毑昅迼捷姐诘蛣椄诫詰疌崨誡嶻骱階卩蓵蛶幯蚧玠戒吤砎倢媘疖刦卪劼
jin	嚍濅筋馑进襟斤近晉矜贐缙菫錦烬賮瑨縉金嫤僸藎覲黅赆钅今谨廑燼尽槿锦鹶惍靳巾僅勁進墐浸矝琎堇儘紟搢珒璡荕琻噤厪荩觐寖緊衿釒歏巹凚祲壗津堻仅觔璶浕紧晋瑾嬧砛禁蓳伒枃溍侭濜兓殣漌釿謹饉齽煡仐卺唫妗盡劤劲
jing	亰徑鏡聙荊淨憼径踁鯨桱景秔麠坕汫竫涇驚泾迳弳阱婙稉脛惊妌竞敬競粳暻幜鼱京莖兢蟼婧璥鶄靖肼汬宑竧麖竸茎鶁儆睛竟瀞頸猄鲸警静璄菁澋痉坙刭靜经胫井腈丼憬弪逕净旌曔經穽橸荆精誩旍凈鵛婛璟靓巠浄経靚镜剄頚痙傹坓梷倞殌獍俓葏晶境劲綡
jiong	侰浻駫炯褧蘏澃扃逈颎迥冏炅絅烱綗駉蘔顈埛窘熲燛囧煛冋煚僒冂泂坰
jiu	玖旧镹殧杦廄鳩欍乣紤丩韮鷲啾廐糺匓舊奺湫揫灸齨牞乆舏鸠揂摎久鬮韭樛咎倃糾究九蹴纠鯦赳鹫氿僦汣麔厩匛匶慦臼勼萛鬏酒救疚揪柩就舅桕柾阄廏朻
ju	跼龃眗齟锔桔籧挙捄鋸锯懅淗椐諊拒钜澽﨔菊挶遽昛犋鉅駶粔袓艍句毩鵙跙崌繘腒娵裾鶋湨鋦榘且讵炬居躹局飓梮鐻駏毱聥犑榉蹫趄鞠埾橘咀泃俱窭屦鞫擧簴侷疽焗巨倨岠踘窶举閰粷怇颶琚罝筥寠弆秬距惧具勮岨躆车匊蒟趜檋雎剧砠輂據狊欅倶蛆鼰莒踞愳凥枸拘詎駒啹婅婮掬椇埧鮔踽椈跔歫鵴邭鮈聚沮巈涺驹驧劇懼貗苴豦虡据壉抅洰柜苣蘜耟鶪蜛姖矩醵櫸鼳舉狙蚷拠泦襷陱鴡屨郹
juan	绢勬臇淃捐朘睊卷隽鎸镌蠲罥蔨絹踡裐焆劵桊捲睠娟鋑慻菤鄄鹃奆瓹巻眷倦羂帣絭锩錈獧埍狷勌餋圈讂腃呟鐫涓悁姢
jue	泬砄訣嶡诀疦爵钁攫阙抉爝臄觖趉蹶鴃噱撅蚗蕨芵噊决脚蹻氒赽鴂劂玨憠貜絶灍崛觮蟩覺绝屫戄蟨決譎匷焳觼躩孒傕鐍桷覚鐝屩谲覐掘撧觉熦憰彏倔弡厥虳蕝亅鳜爴噘絕瑴嶥挗玦欮矡捔鈌角瘚孓斍駃蹷櫭橜崫矍珏镢趹橛刔獗玃嚼爑鷢
jun	竣皲銁军頵菌龟隽鲪莙埈銞儁袀钧懏攈葰箟珺覠駿畯汮麕軍攟浚鵔濬燇姰桾碅峻棞鵕捃均蚐焌皹君晙呁俊郡箘蜠鵘鮶馂麇鍕陖賐麏骏寯雋筠鈞餕皸
ka	鉲喀咖佧胩咯咔垰卡
kai	揩欬奒蒈剴開愾楷暟锎剀开慨恺忾垲凱铠颽锴鎎嵦輆闿塏嘅鍇烗凯愷鎧闓炌勓鐦
kan	矙冚看坎戡欿崁堪墈凵槛刊嵁轗勘歁瞰栞衎闞侃砍惂阚磡輡顑鬫竷龛莰偘龕
kang	炕鏮伉粇槺穅闶鈧钪犺糠慷躿漮砊忼抗囥康亢扛嫝匟閌鱇邟嵻
kao	髛靠烤銬洘犒攷鲓铐鮳丂拷鯌熇栲尻嵪考
ke	轲颏揢缂堁錁碦磕醘骒愘樖渇薖咳钶壳娔珂敤嵑緙騍科瞌匼礚渴勀殼蝌翗殻峇窠痾氪可牱溘刻礊鈳顆呵稞頦趷客克课嵙疴萪坷颗犐恪砢嶱搕課苛髁炣柯棵衉锞嗑岢艐愙勊蚵軻榼牁
ken	錹貇墾恳褃掯垦懇硍肻肯裉豤啃肎
keng	阬摼坑硜鍞誙鏗挳牼妔吭硁銵劥硻铿
kong	倥崆悾箜空涳孔鞚錓控躻硿埪鵼恐
kou	瞉剾摳滱蔻芤瞘筘口眍怐冦鷇叩宼寇釦蔲扣劶彄抠窛敂簆
ku	鮬枯喾楛俈圐苦郀堀褲矻跍骷库窟刳哭绔桍嚳絝酷瘔焅庫狜秙袴裤
kua	垮銙咵趶胯跨骻姱舿夸侉誇挎
kuai	塊鄶狯噲哙浍鱠会筷儈凷墤欳膾郐圦擓糩鲙块巜侩廥蒯快旝澮獪脍
kuan	寛髋髖窽款臗梡宽歀寬欵窾鑧
kuang	诓誆洭诳砿况礦旷鋛壙鉱誑鑛忹矿纩哐岲硄絖爌穬黋筺貺況軦昿邝筐鵟懭圹軠夼眶恇匡框儣曠狅眖纊抂鄺懬絋軭匩邼贶矌軖狂劻
kui	窥愦憒馗楑聵巙鄈葵頍虁匮餽聭睽嘳喟殨簣鍷篑媿愧盔尯蹞騤藈聧揆蒉饋奎巋蘷跬顝溃嬇魁匱馈謉膭逵窺楏躨悝隗櫆晆骙聩刲鍨岿犪傀归暌夔籄蝰喹虧頯戣蕢亏闚潰磈煃
kun	醌裈鹍硱閫髨潉鯤鲲梱悃褌猑睏蜫稇裍髠菎崑壼裩瑻崐焜堃鶤鵾綑壸騉稛坤堒锟祵涃困髡熴阃昆錕琨捆閸晜
kuo	廓蛞括拡霩挄阔闊鞹鬠葀髺筈鞟扩萿頢濶擴栝韕
la	砬揧磖蜡镴瘌瓎辣喇揦啦蝲鬎攋櫴溂辢柆翋鑞癞鯻垃搚剌旯鞡拉腊楋菈邋爉蝋落藞臘嚹臈蠟
lai	来涞麳琜鶆俫襰瀬鵣鯠萊顂倈棶筙賫铼瀨賴藾癩箂庲來賚癞睐徕籁濑騋崃郲赉淶籟崍赖錸睞婡逨梾徠頼莱猍唻
lan	韊蘫榄燣浨譋谰欖纜燗栏兰漤攬懒欗籣爦覽爤斕攔斓鑭懶滥瓓嬾蓝瀾顲爁讕孏嚂壈葻钄囒拦懢览岚缆烂籃糷灠欄擥阑濫蘭篮镧灡繿璼揽醂躝澜罱嵐幱儖褴闌藍襕燷襴灆襤孄襽惏覧婪爛
lang	艆郎樃閬郒朖勆郞蜋浪啷硠琅斏瑯鎯阆躴螂朤塱蓢狼崀锒欴莨烺郎稂鋃嫏誏蒗廊朗蓈筤埌桹榔
lao	牢珯銠老耢耮硓磱澇嘮劳痨铑窂荖髝嗠粩栳獠轑醪橯捞撈浶鐒崂顟姥躼癆唠僗酪軂憦嫪朥蟧耂铹恅络嶗労狫勞憥烙佬咾潦涝哰落閖簩
le	勒叻楽簕扐砳氻鱳艻仂鰳阞餎鳓了嘞竻韷樂玏乐饹忇泐肋
lei	櫐酹礌鑸勒癗蕌蠝泪畾傫诔誄擂虆矋塁磊攂轠壨类鸓類羸纇厽欙礨蘽銇絫雷頛禷纍櫑儡礧罍蘲漯蕾嘞壘藟錑蘱樏鑘讄缧檑縲頪耒儽鼺瓃嫘涙纝灅垒蔂镭颣淚磥累鐳洡肋靁
leng	薐踜愣冷棱碐稜睖塄唥堎楞倰
li	斄鱱逦蛎粒李邐立栎裏秝悷鳨锂磿岦礫刕鑗鳢澧粝禮唎蟍欐檪蘺蝷貍梸躒喱狸儮隷屴剓蒞筣梨轹棙礰哩睝鸝溧吏脷傈利呖歷囄酈嫠厯痢劙壢靂蟸鯏癘厘峢褵儷鉝醨莉枥栃瑮苈離醴疠凓篥瓈峲俐戾艃疬麜理邌俚砅睙籬竰蜧婯穲礪蠣攦赲浰豊蚸瀝禲歴曆蠫縭例轢慄爏茘娳詈叓猁蛠濿厲綟謧鏫黎蓠廲觻厉峛靋里糲鲡轣骊娌涖笠攊孋荔菞砾礼讈唳塛鲤琍犂雳瓑櫔釐漓搮犁鬲沥驪鱧罹癧鷅犡盭跞栛蔾皪礼丽棃鴗鬁蠡力櫟麗隸囇篱嚦勵蜊糎鵹厤櫪曞蒚瓅擽犛纚鋰砺悡鹂粴藶栗盠离鯉爄苙巁隶灕朸莅坜珕沴俪藜鯬欚暦缡鋫錅瓥剺孷励悧蠇黧璃荲裡裏历郦攭樆嚟鱺
lia	俩
lian	聨摙瀲联籨鐮堜斂錬劆璉奁僆琏鄻炼鎌薕裢槤練楝殮煉连萰濂匳嬚鰊蔹帘溓蓮聫恋湅覝濓褳籢連螊襝蘞涟梿磏歛匲燫蹥亷臁噒簾潋奩裣翴漣殓縺臉聯鰱瑓鏈媡练嫾羷鬑怜謰脸戀慩熑纞鲢憐敛澰廉蠊嗹莲镰聮蘝链瀮櫣鍊
liang	辆靓悢喨諒湸辌谅駺俍凉凉脼唡踉椋哴両蜽墚倆粮輬魉俩粱梁倞樑两莨晾魎良緉量輌輛鍄涼兩掚裲亮糧啢
liao	竂鄝尦敹蹽漻寥豂髎窷辽遼嘹聊燎蟟撩爎尥炓獠缭鹩镣鐐嶚嶛镽璙膫飉療膋了蓼繚簝爒廖飂钌憭橑瞭撂僚疗尞廫寮嵺鷯暸釕潦憀料嫽蹘屪藔賿
lie	茢裂劽埒鴷犣鱲巤鬛猎趔列劣蛚聗烈迾咧浖烮煭冽猟擸颲獵姴挒鮤儠埓躐栵捩哷洌鬣
lin	藺嶙廩賃悋淋菻癛蔺吝凜繗躏斴箖鳞焛晽隣璘霖懔隣疄翷潾轥麟轔躙壣撛崊粦邻獜鱗懍躪琳驎临辚僯閵碄粼恡橉亃檩瀶鄰膦臨遴阾蹸凛鏻檁赁厸林癝瞵暽啉拎澟冧燐磷甐廪麐
ling	鲮鈴蛉魿霗岭靈蕶霛霊鸰呤羚跉铃綾蓤玲袊酃鯪零囹皊苓嶺欞鹷令瓴夌崚领龗砱绫祾領昤紷裬錂衑麢澪淩彾駖舲婈坽柃琌狑陵凌櫺笭朎醽岺霝齢閝刢鴒另炩棂翎灵蔆泠伶龄燯秢軨輘姈聆蘦羐竛齡棱孁菱詅爧掕
liu	遛刘磟琉藰留旈磂鹠鹨桞鰡蟉瑬媹六蓅麍硫蹓翏疁碌鎏嵧蒥澑駠橊飅飗裗镠栁馏浏懰飀桺熮瀏绺柳珋廇騮雡飂畱瑠骝駵鏐鶹锍畄劉鐂綹罶驑餾鬸流璢榴溜癅橮瘤陆镏嚠霤斿熘羀鎦旒嬼鷚鋶塯
lo	咯
long	篢滝儱櫳爖漋靇眬龍巄湰龓咙槞壟垄隆昽梇哢壠霳栊篭窿蘢癃鏧曨躘鸗隴竉龙笼襱嶐陇礱泷珑鑨弄贚拢礲驡蠪蠬嚨矓龒瀧徿胧聋朧聾垅茏豅瓏籠巃砻攏竜
lou	镂簍鏤蝼蔞熡屚露嘍蒌瘺瞜陋謱瘘甊篓髅遱漏螻摟喽塿溇嵝廔艛軁漊耧耬嶁鷜婁髏偻搂樓慺娄楼瘻鞻
lu	芦簏魯艣穞虂簵璐鸕泸绿籙鏴鯥舻娽逯枦櫨蓼蘆爐瓐勎虜峍淕路瀘熝鲈椂轆轤曥鵦盧賂顱淥蹗鹵録卢簶蓾菉坴謢廘炉虏澛艪鈩籚鲁鑪攎硉焒赂鸬髗鹿六蕗蠦祿剹甪蔍錄栌螰稑舮箓塷艫滷踛鵱魲辘鑥壚僇氌潞鷺廬矑鏕鱸勠噜鏀硵簬碌醁璷漉馿粶臚辂彔琭庐鴼嚧氇嚕撸輅玈禄膔颅騄樚垆橹圥卤鐪獹露侓摝陸騼戮掳趢轳塶擼纑盝渌罏穋鹭录胪瀂睩黸麓錴陆樐擄櫓镥磠
luan	巒鸞峦鵉鸾孪亂灤欒釠羉癵臠鑾孌攣圞娈栾卵圝脔虊曫滦乱灓孿奱癴脟挛銮
lue	鋝鋢稤寽畧
lun	溣耣轮掄輪碖蜦纶腀錀婨仑囵论踚崙倫鯩菕沦芲淪侖抡棆綸稐論磮惀陯埨圇崘伦
luo	癳捋萝儸硌蠡絡雒箩囖峈逻驘剆曪鮥覼泺騾骡蓏瘰倮荦羅硦笿罗攞鑼濼鏍镙鸁囉洛猡臝漯饠鵅椤咯欏络脶籮詻骆覶洜玀烙摞駱邏跞螺珞落锣裸躶纙蘿腡蠃犖頱啰
lv	呂捋履虑絽氀祣吕榈驴屡率穭箻濾梠挔绿緑膢膂葎膐櫖铝儢櫚膟捛稆屢鑢垏藘鋁嵂綠侶繂滤閭褛氯律慮郘驢勴偻闾侣縷缕旅僂爈褸
lve	掠锊圙略
m	呒姆呣
ma	鎷杩蟆蔴抹痲蟇螞睰碼嘜吗駡鰢閁蚂马鬕唛嘛溤孖鷌傌獁罵麻嫲玛骂榪禡瑪犘嗎媽馬妈亇痳摩码犸祃
mai	霾霢蕒賣勱脉鷶劢麥邁麦荬売卖霡脈佅嘪埋衇迈买買薶
man	鏋馒镘慲獌蛮槾缦瞒嫚鬘蠻螨顢満悗僈蔄曼熳颟漫樠謾澷矕縵鄤滿鏝谩满墁鞔幔屘鰻摱娨鳗蟎埋饅蔓慢襔鬗瞞
mang	蘉茫邙杗哤铓莽莾芒汒笀蠎牤漭駹硭氓蛖盲浝恾蟒吂茻壾狵鋩忙娏釯厖盳尨痝庬杧硥牻
mao	茂氂瑁蝐毷蓩冇卯罞蟊冒柕贸髦昴蝥峁冐皃鄮牦泖楙媢貌茆旄愗毟铆軞矛锚枆鉚覒帽芼萺茅戼耄袤酕毛笷鄚錨鶜猫髳冃貿眊夘瞀堥懋暓貓鉾渵
me	濹嚰么庅嚒嚜
mei	脄鎇魅睸梅跊嵄徾媒湈没眉湄鹛美沒渼祙挴抺郿毎袂珻鬽枚瑂痗躾酶眛坆莓睂镅攗每沬嵋塺栂妹寐玫楣浼篃凂嬍葿脢羙腜糜槑媺镁鋂燘媄昧韎苺楳鎂鶥蝞禖霉猸黴堳黣煤谜媚煝
men	虋闷亹菛們懣穈悶汶们璊玧燜暪门閅門钔懑捫扪鍆焖椚
meng	鯍濛懜瞢懵靀梦掹鯭錳蠓鹲艨猛檬鄳勐黾甿蜢夢擝莔矒鸏蒙霥氓冡虻盟萌氋朦蝱饛獴夣儚幪鼆艋礞蕄懞鄸溕橗顭霿尨甍曚矇锰孟
mi	麿蒾爢鼏宻粎灖祕沕麊覛冪洣蓂羃戂釄咪怽淧糜熐櫁蔝瞇蜜冖葞滵濔禰麛藌鸍幂醚谧漞弭濗靡謎嘧蔤銤覔密醿蘪蘼弥糸羋擟脒峚袮幎沵獼眯孊泌侎醾攠塓米觅迷宓祢覓簚秘瓕敉渳汨榓彌詸縻謐麋镾樒瀰幦猕芈谜
mian	勉緬鮸糆綿睌渑矏澠矈杣葂媔麵勔緜冕麪櫋缅绵矊偭宀棉愐免汅腼芇麫眠嬵靣面俛臱沔湎丏眄娩婂蝒麺靦喕檰
miao	邈瞄藐鹋苗嫹喵竗杪渺淼玅缈鶓庿描妙緲劰缪篎媌廟眇秒庙緢
mie	衊搣幭烕旀哶咩蔑礣篾蠛吀櫗瀎滅灭鱴乜薎鑖懱孭鴓
min	琝黽怋闵笽姄敯閔痻砇悯闽珉緍閩皿潣抿緡盿慜鍲黾忞捪暋憫玟敏缗鈱瑉苠惽旼琘勄敃忟愍崏僶錉蠠冺簢鰵罠刡碈笢湣鳘旻垊岷泯鴖民
ming	朙猽眀冥鸣瞑榠鳴螟鄍眳溟名命暝蓂洺詺凕茗明姳銘慏覭掵铭佲酩嫇
miu	谬缪謬
mo	没瘼膜眜嚤秣麼歿嬤磨魔莫礳寞袜万嬷默砞尛饃眿妺謨懡抹墨魩馍皌髍嗼镆嫼麽蓦嫫莈獏摩饝枺劘末瞐魹冒癦驀纆謩陌銆模茉摸蘑靺鏌塻貊耱爅貃貘蛨漠谟沫藦帓歾糢橅脉瞙殁帞黙嘿眽蟔擵摹圽昩絈无
mou	恈蛑謀某侔眸踎缪鴾麰呣谋繆哞鍪劺牟
mu	胟毣幕霂縸畞暮峔牳氁钼踇睦穆鞪仫鉧幙木姥牧狇牟炑墓苜莫姆畂模沐蚞母楘慕慔牡暯坶鉬莯拇砪目畝募畆雮艒亩畮畒毪
n	嗯唔
na	哪納拿捺钠鎿郍鈉镎那魶呐雫嗱乸内軜貀搻衲娜南纳拏肭吶豽蒳笝袦靹妠
nai	哪嬭柰萘褦螚艿鼐錼奈腉氖孻渿佴奶乃迺廼疓釢耐倷
nan	婻抩湳揇腩煵畘楠難喃莮暔戁遖难南蝻男囝柟萳侽枏囡娚諵赧
nang	饢囔囊馕曩攮儾蠰乪灢欜擃齉嚢
nao	孬譊嶩怓獿淖呶脑悩匘夒蛲恼撓鬧闹閙碙瑙蟯脳惱堖巎鐃獶憹臑嫐峱碯詉铙垴硇猱腦挠
ne	眲呐哪讷抐訥疒呢那
nei	腇錗內鮾哪脮鯘氝内氞馁餒那娞
nen	嫰恁嫩
neng	能
ng	嗯唔
ni	聣惄檷觬嶷掜狔睨匿誽籾淣怩馜棿坭麑霓鯢妳孴旎倪你苨尼擬嫟縌婗嬺吖跜兒伱蚭伲泥逆臡昵儞郳腻隬聻暱鲵猊铌鈮眤妮蜺堄拟儗溺屰齯柅膩呢貎晲薿屔抳氼愵秜胒輗
nian	卄蹍辇鯰焾蔫撚簐碾艌哖攆年廿秊撵鲇蹨念秊惗拈姩唸涊輦粘鮎秥淰捻躎埝鲶黏辗
niang	醸娘釀嬢孃酿
niao	裊袅溺尿褭嬲嬝脲茑鸟鳥樢蔦嫋
nie	臲孼噛讘闑鎳囁槷蹑摰涅踗捏籋帇巕糵嚙啮钀聶鑈櫱蠥圼隉陧錜湼孽苶臬颞嗫嶭敜踙躡鑷揑踂囓篞菍乜枿嵲齧痆糱镍捻镊蘖聂顳
nin	脌囜拰您
ning	薴聹獰寕寍佞宁甯狞寜侫聍鸋泞澝寧咛倿儜苧鑏嚀寗嬣柠擰鬡拧凝矃橣檸濘
niu	扭拗鈕忸杻牜狃钮紐炄靵牛莥纽妞汼
nong	燶繷浓膿挵农鬞醲挊齈禯農欁譨噥弄辳襛濃秾脓癑穠蕽檂儂哝侬
nou	羺鐞鎒槈檽耨獳
nu	努砮怒搙奴孥駑伮胬傉呶驽弩笯
nuan	煗渜奻暖餪
nun	黁
nuo	喏糯梛懧蹃愞那稬诺搦儺娜糥糑鍩锘諾榒橠懦掿挪逽傩穤
nv	衂釹女籹恧朒钕沑衄
nve	疟虐
o	哦筽噢
ou	謳蕅歐鷗藕耦藲嘔毆殴櫙呕慪熰偶吘欧鴎沤鏂塸区腢怄膒甌鸥讴瓯漚
pa	筢啪掱葩妑琶苩耙杷怕汃潖叭袙趴爬帕帊舥皅派
pai	哌輫蒎鎃牌猅箄簰迫沠排俳徘拍簲渒棑派湃
pan	媻泮磻叛詊伴萠拚判扳炍攀般蟠縏牉盼襻盤沜畔柈搫幋蒰瀊溿坢磐冸盘番眅鑻潘爿蹒蹣鞶鵥鋬胖跘拌丬鎜頖槃袢洀
pang	磅霶彷逄嗙肨厐螃舽鰟胮耪炐龐髈庞覫仿嫎膖徬鳑龎滂胖乓雱眫旁膀
pao	鞄抛礟拋麃炰靤泡皰砲褜奅麭礮刨炮袍軳狍疱咆匏脬萢跑袌庖垉麅爮
pei	旆毰辔賠蓜阫胚浿斾培沛衃珮裵俖犻霈怌陪帔姵配伂呸裴佩轡锫肧醅赔錇馷
pen	呠翸噴喯盆濆湓瓫歕葐喷
peng	傰淎篣輧韸烹軯鬅鹏泙騯槰搒漰砰弸掽碰竼捧恲磞椖塳棚匉塜芃輣膨朋蓬怦稝抨倗熢蟛篷嘭髼駍閛莑彭蘕纄鬔澎鵬剻皏椪踫梈硑錋硼鑝樥憉蟚韼堋袶捀
phos	喸
pi	魮圮鲏睥媲鎞椑擗辟鵧批霹旇貔錃翍肶駓礔陴嫓苉噽毘隦脴琵纰羆郫豾邳譬篺秛脾噼紕坯磇鼙嚭铍枈癖啤披丕澼狉闢稫伾罴膍鈹鴄鷿銢錍鈚仳秠甓吡毗匹壀釽螷鮍魾耚鉟潎蚽蚍嶏抷蠯陂裨阰髬腗礕否悂痞伓蚾屁淠諀揊狓僻疈鸊蜱憵劈被砒芘焷庀崥埤疲炋皮銔枇岯豼
pian	谝翩缏貵便骿騗諞騙骈楄跰囨駢蹁腁騈媥犏賆楩片扁覑篇骗褊偏鶣胼
piao	漂縹犥嘌朴螵骠旚剽翲莩勡飘薸驃皫票僄篻嫖鰾醥顠徱殍魒飃慓彯缥瓢瞟闝飄
pie	撇覕氕瞥暼鐅丿撆苤嫳
pin	娦礗姘馪朩穦汖拚娉贫琕榀品嬪貧砏玭驞嫔顰嚬聘拼频颦矉牝蘋薲
ping	胓砯枰蚲軿聠甹评娉艵萍蓱箳帡帲憑淜玶冯蛢鮃苹乒涄俜郱屏荓缾凴焩簈幈岼屛甁竮平坪檘評洴慿頩塀鲆凭瓶呯
po	岥笸珀砶坡破粕朴醗鄱尀魄桲廹岶昢酦醱迫繁婆嘙蒪泼陂潑泊颇叵釙洦箥皤湐钋鏺櫇頗鉕钷嚩敀烞蔢駊
pou	婄箁掊捊抙娝犃剖咅垺哣裒抔
ppun	哛
pu	鐠曝攵抪炇痡镤普暜朴莆僕譜墣圑噗獛铺鋪溥纀檏镨葡舗舖陠瀑堡穙匍瞨攴菩巬樸谱諩鯆濮璞浦暴酺贌蹼脯氆鏷扑菐潽蒲埔圃圤擈烳撲蒱仆
qi	斊璂唭齊暣盵綥琪綮愒唘魌蜞啔荠妻鲯矵碛綺僛摖崎弃岂萕忯祺蘄憩祈乞泣鏚蹊岓沏埼軝玘婍掑期磜鰭鬿騎淒旂企櫀蠐丌棲亓藄罊亝玂汔麒鶈悽讫淇琦绮霋紪啟屺慽颀炁迄棨稽祁岐螧藒鯕倛棄慼盀俟歧鐑榿骑啓七芪甈帺簱嘁漆萁鳍訖懠蕲呇鵸其碕蛴憇气夡敧芑騏鶀噐猉騹旗粸娸褄晵攲滊錡杞艩祇脐闙豈肵釮禥器郪頎綦起嵜碁缉濝麡疧亟墄邔愭戚蟿芞迉启碶捿欺気籏汽呮棋剘圻畦湆咠萋褀齐磧緀鄿簯湇锜踦桤傶檱臍跂啐欹骐栔磩氣契柒葺槭諬蚑鬐蚔蜝蚚斉奇凄砌耆陭﨑竒栖棊桼欫
qia	酠掐袷葜圶冾帢鞐拤洽髂硈峠跒恰殎胢擖卡
qian	欠阡鵮橬歉篟忴綪汘悭棈攐鈆黚谴鉗拑籤葥嗛扦騝臤潜仱钎仟蚈騚槏缱櫏鉛皘釺乾悓竏遷韆前岍籖靬掔儙槧鬜蜸謙攑牽佥簽乹壍芡軡圱嵌荨諐茾塹榩遣岒鏲堑千顅僉鰬杄圲签褰錢偂潛蒨虔鎆騫椠铅骞撁膁亁犍檶鈐媊钳鬝孯粁箝攓钱谦傔繾钤伣揵濳灊譴俔淺掮牵汧拪浅縴鹐篏迁歬纤墘慊銭搴慳愆扲刋厱奷肷芊輤黔茜羬婜嬱蔳倩谸蕁欦
qiang	羫樯嗴槍蹡繦嫱羻锵溬锖玱强抢繈羌蹌嬙牄檣唴将椌薔羟墏彊枪炝搶镪獇蘠艢熗墙羗謒牆篬呛斨鏘跄蔃啌蜣嶈羥戕襁鏹墻強蔷嗆戗摤廧鎗漒猐瑲腔戧
qiao	鄥缲愀誚鐰壳癄墧郻髜釥撬嫶桥槗磽巧荍鍬蕉顦鞽躈藮僑譙趬橋喬憔燋櫵菬帩悄僺髚鐈乔硗蕎跷毃雀墽頝蹺瞧橇劁鞒鄡翹犞竅敲韒侨墝翘繑峭礄鍫谯锹踍鞩撽窍峤陗趫嘺樵勪硚鞘俏幧繰诮燆荞骹
qie	窃笡聺箧穕愜厒惬挈悏切篋朅趄匧怯慊鍥踥洯鯜淁癿蛪竊锲伽砌妾且茄
qin	欽菳斳寑搇侵覃赾瀙锓雂亲嵰嗪吣撳琴嵚廑噙鳹瘽抋蚙懃藽芩昑鮼蠄沁揿溱矜秦親埐靲菦梫坅寴駸衾鵭螓吢顉钦嶔捦擒琹嶜澿懄珡媇慬檎鋟耹寢唚嫀庈鈙禽笉寝骎菣螼肣綅誛鈫芹勤
qing	郬葝鯖寈謦庆氢樈掅亲倾氰黥轻鲭鑋漀圊青晴擎磬棾殑请甠錆啨苘綮埥蜻殸箐清凊濪卿頃庼硘傾靘請情檠夝顷靑慶儬擏軽勍暒罄櫦倩碃淸氫檾剠廎輕
qiong	茕熍瓗橩嬛卭竆儝憌宆邛焭琼桏穷舼瞏煢跫惸笻銎窮藑蛩璚蛬赹瓊筇睘焪穹藭
qiu	鹙釚殏鶖逎緧蠤坵虯鰍璆篍恘犰訄酋唒煪扏萩蛷囚龟鞧渞秌湬崷球鞦蘒朹訅觩搝芁蚯赇求糗蟗鼽穐丠紌仇丘裘毬釻銶楸梂浗肍湫玌絿恷湭泅賕蝤鮂汓邱蘒媝頄盚叴遒醔趥觓皳蓲俅巯秋巰鳅莍虬蝵逑鰌龝鯄鰽
qu	磲诎灈籧娶去氍袪岖阹蕖鴝螶耝敺麴衢鼩癯駆岴憈鱋璩蝺趣斪蠼閴蟝忂胊取蛐絇鶌屈爠觑麮區嶇朐鸜璖欋鰸瞿粬躯刞佢齲佉魼竘祛驅竬軀区坥趋蘧誳伹龋匤戵淭浀鼁抾紶驱蠷麯詘欔煀劬翑葋趨呿筁趍衐蛆黢駈軥鑺曲戌闃阒菃鸲覻躣苣渠覷麹詓焌覰髷胠厺臞
quan	棬蜷箞権虇峑姾硂筌搼卷绻劝絟椦悛惓踡牷铨瑔騡蠸犬牶勸畎齤拳跧勧巏啳鐉痊诠辁綣弮銓韏奍駩犮券醛烇埢顴觠圏闎全婘葲縓鬈鳈荃犭輇权佺泉鰁犈颧權湶圈恮楾詮洤
que	碏蒛却瘸棤硞琷阕阙闕燩趞礭愨鹊塙皵搉确碻埆炔缺闋榷卻雀礐鵲悫崅確慤缼芍
qun	囷麇逡峮群宭裠帬夋羣裙
ran	髥蚺然橪繎衻珃冄冉蚦嘫燃呥髯姌袡染肰苒媣袇
rang	瀼瓤攘讓獽壌懹蘘勷儴禳躟穰壤穣嚷鬤爙让譲
rao	遶荛饶蕘饒娆繞扰绕嬈隢擾桡襓橈
re	热惹喏熱若
ren	魜銋讱秹亻紉餁紝刄荏忎韧袵韌靭衽认認軔仭朲纫任鈓纴忍秂躵忈芢轫絍人肕腍壬栣梕稔荵靱姙仞妊飪祍鵀刃屻饪仁杒葚栠訒牣
reng	芿艿仍礽辸陾扔
ri	驲釼釰日鈤囸衵馹
rong	瑢嵘冗蠑螎羢駥爃氄镕軵嶸絨槦縙茙榮蝾茸狨曧坈榵穃荣嬫傇栄毧嫆峵傛搈褣搑融鎔瀜熔溶绒蓉烿戎穁容宂嵤榕媶肜
rou	譳瓇肉鶔脜宍輮蹂揉韖騥煣楺葇糅渘禸瑈粈腬鰇媃鍒鞣厹蝚柔
ru	汝邚蓐縟嗕袽鴑洳襦杁蒘醹擩筎肗銣鴽嶿茹嚅挐缛蠕侞蝡顬褥鱬帤曘蕠乳入薷颥辱濡鄏桇媷渪如儒铷孺溽嬬
ruan	撋堧壖耎媆輭阮朊腝瓀碝偄软瑌軟緛礝
rui	甤蘃睿蘂壡桵鋭瑞叡橤蕊銳芮繠蜹锐蕤汭枘蕋蚋緌
run	膶閏闰橍潤润閠
ruo	渃叒弱楉偌嵶鄀挼鰙鶸蒻婼焫鰯爇箬篛若捼
sa	潵撒訯萨隡薩脎櫒卅洒蕯馺钑摋靸躠鈒颯仨灑飒
sai	毸顋噻思鰓毢嗮簺赛鳃嘥僿賽愢腮揌塞
san	参毵俕壭閐散糝糁叁厁鏒糤毿伞弎三饊犙傘鏾繖毶馓鬖糣
sang	颡喪褬顙槡嗓搡磉鎟丧桒桑
sao	瘙溞髞嫂扫螦搔矂埽缫繅氉骚臊掃燥鰠鱢騷慅颾騒掻鳋
se	瑟璱雭歰轖澁飋濇渋摵繬穡铯銫涩色擌瘷鱪塞洓歮譅濏鏼懎啬栜穯嗇閪瀒穑澀
sen	槮椮森襂
seng	鬙僧
sha	裟閷奢厦挲箑帹煞砂莎啥猀樧儍鯋榝噎粆倽嗄霎杉铩鎩紗魦喢萐廈沙鲨唦桬傻翣閯痧翜摋繺歃硰髿啑刹纱殺鯊唼杀蔱
shai	籭曬簛色篩酾簁筛晒
shan	讪扇禅鯅脠笘山珊磰墠剼炶晱樿剡痁熌譱嘇銏閃陕邖掸赸舢删嬗謆衫陝彡柵鳝栅赡膻敾禪挻姍傓疝軕闪羴搧芟钐煔骟杉澘贍縿騸饍狦幓蟺姗繕椫膳潸檆睒擅鱓善苫訕汕歚掺灗覢羶僐鐥跚煽蟮圸墡釤单缮鄯刪鱔掞
shang	樉鑜熵傷扄觞伤賞尚尙绱商觴晌贘螪上殤禓謪鞝汤丄赏裳鬺蔏鋿垧恦殇鏛漡墒滳緔慯
shao	焼蕱劭邵梢绍紹睄勺少卲捎輎鞘袑娋莦蛸髾柖杓烧苕韶哨燒稍艄旓筲玿弰萷潲綤鮹芍
she	畭揲阇奢蛇舌設叶攝輋舎檨设弽騇猞虵欇慴折赦賒懾舍畲蛥摂摄涉韘灄畬社渉拾滠麝蔎歙蠂厙涻慑赊捨賖厍佘射
shei	谁
shen	姺甡葠鵢魫峷鉮伸脤曋嬸祳鋠愼什胂哂诜眒涁瘆葚鯵腎籶谉紳審訷慎蜃罙裑侁棯渗諗身珅矧娠扟申肾堔神敒眘妽莘呻蔘椹籸沈駪糁冞氠瞫滲鲹昚糂屾邥深詵頣兟榊讅婶谂鯓鰰审砷燊訠渖瀋甧覾蓡曑薓罧瘮柛蜄鰺甚穼弞侺绅矤参
sheng	陞勝圣剩渻貹昇賸焺榺晠渑鍟偗鼪湦笙譝盛聖縄斘省苼鉎聲甥眚繩呏晟胜剰陹乘珄泩牲琞竔橳繉憴曻鵿﨡狌殅墭升生枡蕂阩声绳嵊
shi	栻鉽驶佦蝕睗谥酾蝨噬式眎褷筮鰘獅釶誓埘失舐蒒屎徥實卋鍦簭冟詩勢狮鉂什识螫始試鉐饰豕室蓍籂恀湿諟实似恃銴餝諡鈰尸実市柹轼柿祏使塒鼫鉇鰣炻势嬕嘘辻鼭拾适視湤榯煶戺邿謚示施殖眡士枾眂烒鉃遈溼飠適崼姼蚀是峕峙釈軾舓濕丗仕事宩试貰旹氏秲弒逝時飾虱釃视鸤石鰤識瑡寔浉師竍呩屍遾诗礻弑忕奭觢溡鶳駛溮史兘侍贳师十鮖铈揓嵵鲥亊食鲺葹释矢笶鳲鳾襹时乨嗜餙襫澨世匙釋呞湜鯴昰絁莳拭蒔饣箷
shou	兽獸受狩収授痩垨膄瘦守寿绶手售壽涭熟鏉扌夀艏首綬獣收
shu	姝攄鉥婌腧朮漱输澍薯数襩书孰綀橾屬術潻纾束軗鵨蠴書竪毺瀭殊暏豎疎尌熟叔樞鄃咰曙树竖沭陎贖輸淑塾殳藷梳摅庶荼鼠庻尗數絉抒属疏紓霔秫焂倏黍癙掓倐樹鶐捒蜀恕錰跾述戍墅薥侸舒踈毹蒁濖术琡赎糬襡菽怷潄署枢蔬璹荗裋虪暑鮛儵鏣杸
shua	耍唰誜刷
shuai	甩蟀衰卛摔帅帥率
shuan	涮腨閂拴栓闩
shuang	縔騻孀礵慡鸘爽漺驦雙灀泷塽双鏯鹴﨎骦孇霜鷞欆艭
shui	税谁氵氺水涗说脽祱裞睡帨涚誰稅
shun	瞚顺蕣順鬊瞤橓楯舜瞬吮
shuo	铄說朔欶獡鑠搠爍说説烁妁硕矟箾鎙碩槊蒴
si	鈻禠嗣覗緦肆思虒巳泗亖絲竢四偲飤鷥駟凘孠杫缌泀泤柶司螄儩笥鼶榹纟俬貄似廝瀃寺枱洍撕饲鐁驷蜤耛糹価鈶娰騦俟蟴禩私蕼牭咝鉰汜涘飼燍嘶澌锶鍶恖姒噝釲丝銯伺罳颸媤耜祀厮洠肂斯蕬厕鸶兕蛳食飔梩蟖佀厶楒禗死磃鋖
song	嵩竦耸讼松颂餸慫濍悚駷傱凇娀愯梥崧送倯嵷诵枩菘憽宋柗怂枀訟庺頌淞硹鎹檧忪鬆楤聳誦
sou	獀颼溲騪馊櫢锼瘶薮艘鎪傁嗖蓃餿藪凁籔飕蒐廀醙擻叟擞鄋叜摗廋嗽捜搜摉螋嗾瞍
su	穌涑夙櫯洬觫窣樎蘓趚鹔僳塐餗谡憟殐鯂溸稣鱐泝愬傃驌嗉缩遡甦溯簌訴玊膆潚潥橚苏速素骕蘇诉塑粛榡肃碿宿俗粟蹜樕梀鷫鋉蔌璛謖嫊藗酥莤囌珟肅遬愫縤
suan	匴笇酸痠筭蒜算祘狻
sui	浽繀绥祟埣睢繐芕鞖睟膸熣嵗煫隋遂岁碎鐆綏譢粹澻穟荽燧倠韢髓髄繸隨眭穗谇旞誶遀穂璲尿瓍瀡砕歲虽随滖亗哸禭鐩濉夊賥雖嬘荾邃檖隧歳襚
sun	飧蕵狲飱榫搎槂箰笋荪猻孙鶽薞潠孫损隼簨筍鎨損蓀
suo	挲所蓑莎莏挱娑鎖簑嗩傞溑桫褨縮缩溹鮻趖锁琑摍琐嗦蜶鏁簔唆惢暛梭唢鎍璅逤睃鎻索瑣嗍羧
ta	錔蹹它遝榻撻塔獺獭鞳她鞜嚃狧嚺挞禢遢橽鰨鉈崉搨傝毾漯蹋闼涾譶祂褟沓闒塌誻溻鮙趿阘躢拓粏濌闥踏澾鳎牠溚嗒墖侤铊榙
tai	薹旲邰籉跆嬯囼擡骀汏太酞态孡箈肽抬汰儓冭態駘忲炲坮台泰钛呔汱臺鈦檯鮐胎炱燤鲐舦颱菭苔溙夳
tan	坦醓湠貚貪罈璮埮覃惔瘫談啴澹嘆藫壇墵僋舕忐燂昙暺碳坛倓醈摊攤錟曇菼歎醰怹坍嗿婒滩嘽潬檀鉭毯憛探叹罎榃顃谭灘痰譚郯壜墰袒炭潭擹憳憻癱譠钽痑锬舑贪谈弹橝
tang	漟曭蹚坣禟樘橖蝪榶铴劏瑭糖鄌鼞闛耥摥淌磄倘嘡鏜蓎煻鐋螗矘羰鎲戃傥棠伖溏啺唐塘帑躺镗汤膛篖醣糛餹薚饄镋湯烫儻惝鞺傏堂搪糃鎕钂爣偒鶶燙隚螳踼赯趟膅
tao	绦縧裪鞀駣騊瑫涛夲鞱飸陶套鼗謟鋾綯祹鞉咷詜嫍縚焘讨逃桃淘濤絛梼叨萄蜪掏幍槄轁韜啕慆搯匋弢韬饕洮醄討绹滔迯饀
te	脦鋱忒蟘特铽忑慝
teng	邆霯滕鼟駦腾疼膯螣儯誊籘籐漛藤虅縢鰧痋騰謄驣幐
ti	蹄鵜體剃碮锑倜銻骵踢瑅屉鳀崹厗鯷鬀稊提緹裼渧揥啑逷褆鹈醍歒綈嗁蹏嚏鷈逖蕛褅鬄徲罤剔鮷啼軆挮睼屜惿笹体涕题鶗趧鷉薙荑籊鷤替禵殢鍗遆洟趯俶鶙題掦騠髰偍悐擿悌惖嚔绨戻惕謕漽梯瓋缇媞躰
tian	璳畑悿填靔田緂畠錪婖嗔天屇阗甜餂塡闐淟搷賟碵黇琠瑱鴫钿腆靝忝恬胋磌痶湉睓晪舔觍鷏甛酟兲窴倎添掭沺覥畋唺佃鷆舚菾殄
tiao	鰷窱齠岹蓚岧條挑趒粜庣絩斢祧龆条鲦脁鋚鞗鎥髫调跳宨朓糶笤恌苕晀覜蓨樤蜩迢佻旫窕誂祒眺芀嬥鯈萔聎
tie	蛈铁聑帖贴怗鉄萜飻僣驖鐵銕餮鐡呫貼
ting	聼蜓廷汀侹艇耓圢烶娗铤蝏綎霆颋町頲烃厅厛嵉榳渟廳葶涏聴廰停脡楟鋌庭桯亭莛鼮聽甼庁梃誔邒婷筳挺听珽聤閮諪鞓烴
tong	慟峝勭垌獞橦粡銅餇鲖鮦膧同庝統筒峒絧哃烔秱詷侗炵僮憅茼通浵彤曈桶犝鉵潼峂氃蓪桐铜燑嗵佟朣瞳砼统酮晍樋痌蚒穜赨狪筩痛眮童鉖捅熥仝恫衕
tou	頭婾媮偷鍮敨黈妵投偸头鋀亠紏蘣骰透
tu	突鈯酴鵵鶟禿庩塗瑹鼵兎兔涂葖荼堍馟迌菟鍎鵚痜怢屠釷鵌跿図秃瘏梌图廜唋悇捸峹嶀駼徒钍鋵涋土蒤鷵堗捈途腯汢圖莵宊凸吐稌圡嵞凃揬湥筡鷋圗潳
tuan	湍貒槫慱煓漙団剸畽抟篿鏄圕褖鷻糰摶檲鷒墥疃團团湪彖猯
tui	颓蛻俀退褪僓橔魋蹆蘈隤蹪煺娧頺穨頹駾推蜕侻骽弚忒腿藬尵頽蓷
tun	豚褪軘旽氽臀呑坉芚臋飩魨涒鲀黗暾囤吞朜霕噋豘饨焞忳屯蛌
tuo	咃蘀沱鴕沰挩鮵柁馱駝岮鸵拕鼉唾坨彵箨驝妥魄涶袉鼧橢嶞砣酡魠佗捝袥脱橐嫷驒柝跎詑侂馲乇託阤狏槖騨饦碢讬托紽陀籜仛杔萚鵎汑驼扡跅駞驮鼍駄鮀侻陁砤椭拓庹毻鰖咜说脫楕毤莌飥堶拖
wa	瓾鼃畖洼腽窪娃襪挖屲咓佤蛙窐漥溛搲聉砙攨哇袜穵瓦邷媧嗗嗢韈啘窊膃凹韤劸娲
wai	歪竵咼喎顡崴外
wan	睕杤帵潫丸顽卍豌脕梚貦蟃汍贃挽乛彎蜿抏踠萖惋妧剜壪塆纨婉晩鋔鋄鎫贎笂薍完灣輐畹宛芄倇琬晼玩绾弯菀腕碗晚万忨萬卐澫錽綰綩椀烷湾刓翫唍莞輓盌捥婠埦捖頑皖瞣紈晥琓蔓脘岏
wang	罓彺網尫尣辋枉蛧旺朢尩莣菵瀇尢忘蝄亡惘妄仼魍汪徍亾迋罒棢誷网蚟輞尪兦王往徃罔暀望
wei	腲菋闈斖懀瀢伪濻峞煨芛帷未鲔韦讆頠愄蜲囲椳韙鮪暐荱骩蘶韪叞罻嶉燰隗为萎煒湋硙餵魏鳂揻溦潍痿鍡偎鮇覹維儰媦鏏威惟骫慰苇壝緯苿捤縅墛媙纬圍饖蝟违危娓躛爲碨囗帏讏沩薇潙欈葦韋煟癓撱偉洧鰄洈亹嵔轊痏艉醀颹媁谓蔿崣偽硊烓餧葳卫葨峗藯薳褽畏桅维螱玮潿霺蓶諉渭磑軎揋韡緭巍嶶犚味胃躗鰃鄬猬唯違衞鳚覣委踓蔚徫猥霨微琟矀尾濰為位喴梶隇崴厃伟逶瑋骪衛廆犩鮠椲僞圩围蒍熭隈寪詴遗嵬闱溈渨喂诿涠浘謂炜尉蜼鍏愇楲韑蝛幃喡
wen	鴍抆莬蟁穏轀鰛塭揾温瘟絻溫昷刎伆榅蕰問紋闻搵聞顐繧緼豱妏璺辒鰮汶閿文瑥鳁馼榲闅闦吻蚊渂问脗桽蚉鎾芠魰駇阌肳稳雯呅饂免呡紊穩纹鳼炆彣閺殟輼鞰螡鼤珳瘒
weng	甕奣嵡齆翁攚聬蕹嗡勜鶲蓊暡鹟罋塕螉滃瞈鎓瓮
wo	偓仴萵沃喔卧臒猧涴齷踒捾幄臥腛肟涡硪龌婐婑窩濣楃窝捰倭瞃媉挝蜗莴涹我握斡蝸唩渥枂瓁焥渦
wu	無霧汙吴弙剭铻焐蘁怃鵐伍呉汚螐五鯃倵亡隖儛恶碔兀忢浯洿钨娬屼妩啎婺武墲鎢鹀莁杇珸璑鋈窏鹜物兀蕪粅塢祦诬鹉鵡誤舞鄔憮毋梧陚熓霚呜誈鋙悞鼿瑦卼悮蟱嫵嵨廡峿岉奦务娪靰扤窹誣務芴珷蜈阢污屋歍茣捂坞午玝矹熃邬巫譕雺悟娒鼯牾郚唔迕溩芜痦箼雾俉齀旿於戊逜勿嗚敄吳鶩甒乌鰞瞴潕晤吾烏忤嵍騖圬洖鴮橆鷡躌骛侮仵误杌无庑寤摀
xi	衋矽鎴潟酅肸夕磶蕮扸檄硒厀椺墍焁熂鈢郗覡屣翖睎悉郤戱憙蠵焟騽隙煕惜禧緆槢菥趇繥襲饻犔锡兮唏蓰屓咥裼隵暿爔漝隟橲螇觹皙鸂習鐊蒵覤潝蹊鉨狶恄西鰼囍譆曦觽犀熙怬吸郋憘徯鵗俙霫禊餏铣牺巂徙怸舄屃浠翕樨釸邜犧绤席枲釳歖綌奚袭呬凞璽桸嘻欯塈騱豀琋晰褶矖係澙恓晳稧躧屭嬆徆熺醯赥諰漇虩鬩錫悕淅霼舾縰觋舃娭慀謑汐喺繫磎溪熈息壐焈喜烯饩习蜥鳛鏭薂葸希欷析忚歙焬嵠螅窸謵肹葈饎莃系餼闟戏巇唽昔腊细豨盻熄糦氥惁嶍粞蒠犠飁鉩卥瘜蹝縘屖瞦洗礂嚱豯驨渓忥稀橀郄媳鄎阋噏僖赩戲匸榽熻傒鱚貕膝鑴燨戯穸茜羲椞黖嬉蟋趘細谿蟢晞玺卌觿鼷隰熹栖蓆
xia	夓厦蕸閕颬狎烚狭埉瑕鎼蝦陿舝吓侠辖圷珨煆翈傄黠騢閜丅懗鍜柙峽舺遐硖夏諕炠縖陜鎋假魻俠硤鶷鏬峡赮呷磍谺筪暇虾唬敮狹下鰕碬葭疜罅霞匣睱瞎祫轄梺
xian	僲獻県陷娹峴啣諴閒綫鮮搟咞缐枮衔现娊莧褼醎屳箲韅垷線掀銑先嗛玁闲礥霰鹇跣燹佡嫌籼献羨現僩麙胘珗豏苋鋧撊澖撏仙銜橺銛秈贒崄鑦襳縣铣险鹹麲羡薟閑睍衘櫶奾鲜躚幰伭孅限尟攕线僊獫賢暹蹮烍痫憪馅忺涎嫻蚬獮鼸蛝岘尠腺壏莶娴藓挦显馦藖譣鍁咸姭蚿筅妶顯仚哯弦攇晛瀗毨禒埳橌臽跹険婱锨繊甉陥灦瞯贤祆蜆誸鶱銽杴苮僴韯鷼猃县塪鱻憸鍌險嫺嘕咁舷絃盷蘚氙廯纎洗赻铦粯纤宪酰韱誢絤湺餡糮錎顕臔羬嶮鷴冼涀见癇憲輱稴鷳狝癎纖嬐
xiang	欀膷麘詳缿骧勨香箱鱶响相鯗饗向項橡衖薌瓖像葙栙蚃驤鮝襐楿详絴芗饷庠亯晑響嶑鱌郷銄纕蠁巷象湘蟓餉瓨廂忀鄉鄊佭项曏乡厢饟鲞翔镶姠鐌飨缃鄕緗想嚮萫跭降珦襄鑲享祥
xiao	小削鴵箫誵篠髐歊枵淆嘐詨蛸翛瀟膮郩嚻啸歗硣曉撨魈涍髇鷍笑呺灲嘵効誟窙蠨肖斅逍踃謏殽囂哓蟏毊櫹潇颵簘憢驍穘綃﨧校灱敩霄藃蕭虈烋庨熽枭嘋恔蟂消訤婋绡孝銷皛揱嚣鸮哮效筿蟰梟侾咲痟痚销簫彇皢宯鴞焇硝筱洨斆猇傚暁嘨虓晓獢宵崤俲骁嘯萧
xie	峫薤瀉缬嚡讗亵噧灺械卸蟹屧勰猲膎諧絬褻靾綊瀣瑎謝邂泄齥絜緳解襭齘榍韰齛蝢藛揳娎胁血廨偞邪炧卨楔衺祄蠍挟絏奊熁愶撷些鞵協偕垥劦冩蠏褉齂渫縀泻协燲薢脋伳嶰蝎拹媟徢擕鞋懈叶嗋榭恊缷禼旪爕紲糏躞燮炨焎挾屟夑脅斜緤谢僁洩写龤纈擷屑烲翓鲑谐偰孈暬契獬寫澥歇携攜绁繲鞢脇塮
xin	馫莘歆信訢衅辛鑫枔镡軐脪焮囟忻昕鈊廞伈孞芯妡新炘欣薪舋襑惞锌心鋅嬜忄俽杺馨釁馸顖阠訫鐔盺邤噷伩
xing	郉莕鯹骍篂洐荇侀鉶觲鈃婞铏滎餳杏饧娙緈刑陉擤省荥型性姓邢﨨哘皨垶銒陘腥觪行惺悻曐鮏硎醒猩狌倖睲興騂星瑆煋幸臖謃葕形钘鋞涬嬹箵蛵兴
xiong	胸凶賯恟雄詗汹訩焸芎忷诇熊熋讻詾焽胷洶匈兇夐兄敻匂哅
xiu	褎褏臭鱃鸺袖鮴髹修繡飍滫嚊朽俢溴貅休螑烌鎀绣锈苬琇繍樇臹髤脙潃岫銹庥咻饈羞峀脩宿齅銝糔嗅馐鵂鏥秀鏽珛璓綉鏅
xu	偦稰怴槒綇鱮伵譃昫卹畜吁栩蓿聟勗壻滀垿詡烼敍慉欨揟糈喣顼呴媭緰銊瞁鑐汿盱魆禑冔蝑浒噓砉墟胥敘煦諝訹疞嘘许鄦聓縃诩欻俆訏盨続魣須续朂序叙酗鬚湑恤藚續旴需賉烅許潊魖暊歔旭稸緖藇盢裇蒣婿燸醑徐絮珬溆戌须頊嬃諿楈漵殈蕦侐歘驉緒虗圩繻勖沀绪晇虚欰蓄谞﨏姁獝虛芧洫珝
xuan	翾碹蜁儇諼癬玄吅檈媗駽谖烜渲悬縼鏇琄禤璿漩箮弲譞翧諠喧揎煊轩眩蠉晅蕿藼泫炫煖睻颴暶璇蘐鋗鞙选矎絢楦鍹贙選嬛镟塇癣萲軒萱券铉县懸楥懁瑄鉉繏暄怰琁绚嫙蓒眴愋蝖玹宣昍蔙袨愃衒梋旋痃昡咺
xue	削鳕吷瞲學蒆血彐穴趐踅茓辥峃謔泶觷袕膤鞾坹燢雪壆靴鷽斈乴学噱谑瀥鸴澩樰岤桖薛鱈疶狘嶨轌辪
xun	灥詢卂驯廵杊郇臐焄迅蟳揗荤浚璕峋旬殉稄燖駨訓鱘毥狥汛熏迿訙讯勲壎寻坃奞愻训荨爋畃蘍珣嚑鑂潯矄塤纁鄩侚薫訊燅馴栒攳巺恂獯潭紃樳逊桪噀循巡巽醺埙曛噚燻壦询遜薰殾洵尋勛伨窨徇偱蕈顨勋鲟荀鱏勳
ya	亜氩ㄚ冴釾痖砑瘂枒圠轧覀讶唖漄压哑埡孲铔齾劜睚鸭岈揠亞吖鴉啞俹涯軋鵶蚜厓崖聐氬桠衙笌崕圔鸦椏錏玡呀鐚疋訝窫牙庘伢壓婭琊厊丫娅猰猚厌鴨齖疨堐芽迓挜垭圧雅庌稏押犽蕥襾亚掗
yan	蜒巚諺觃鴳黡囐嚈煙黶堰醼揜讠珚艶喦閆焔厣櫩閹訮闫炎俨漹檐烟芫嵼顩騐鷰硯儼剡鶠釅夵淹演樮揅琰厭弇鰋偃驠彦兖灔牪咽魇椻烻懕綖嚴麣罨唁灎腌蔅豔湮雁戭熖滟燕鴈谚谳隁贗鹽礹厴歅奄猒艳萒偐虤阉盐齴騴彥詽姸縯壧隒裺殷鼴黫延研鳫艷狿灧焉傿啱淊顏硽岩嬮兗龑顔娫塩掩颜渷鬳驗豓郾巘嬿酽验巗觾遃嵃暥黤曮酀饜敥剦赝餍嵒齞燄讞铅愝严衍焱黬郔醶鄢椼扊魘妍曣琂酓厌閻懨爓讌曕筵厳嵓匽妟姲眼贋簷檿砚埏乵覎崦莚嶖晏巖軅抁言醃阏褗昖楌巌阎娮晻炏甗宴臙訁恹渰噞験硏嚥沿灩鼹嫣墕阽躽蝘鷃焰孍壛碞喭黭棪溎嬊胭篶沇
yang	樣炴珜養洋佯扬佒抰陽烊輰岟鸯揚央軮劷氱諹慃攁暘炀霷楧氜崵胦阦姎駚鸉阳飬紻懩昜蛘样漾飏颺鞅羊瑒秧殃鴹雵楊咉様仰羏瀁羕癢傟氧眏垟詇卬养坱蝆鰑怏敭徉钖煬瘍疡恙鉠旸柍礢杨鴦崸眻痒鍚泱鍈
yao	溔猺嗂抭楆鰩熎袎訞狕軺餆窰鳐鎐仸滧葽窑嶢尧鴢瑶喓顤崾窯姚殀摿鱙堯暚餚獟遙尭妖要鹞苭倄夭艞岆揺靿謡陶邀侥傜徼纅榚飖吆荛鼼约杳瑤覞葯燿峣窔闄齩讑疟繇搖遥嶤眑邎珧榣钥垚爻鴁药蘨穾烑摇耀曜腰窅轺磘婹铫蓔詏宎舀祅柼窈咬徭偠幺謠藥矅谣鷕愮媱筄騕薬鷂颻肴枖
ye	鄴澲嶫枽潱頁鵺壄嘢爷馌鍱亪曳殗瑘叶冶拽鋣邪暍噎页鎑擪铘鸈耶捓鎁倻漜璍嶪瞸驜埜爺椰邺靨也捙晔皣曵餣揶僷爗抴ㄝ野业液曄煠燁擫曗腋亱饁歋夜瞱礏擨業蠮枼吔烨墷靥咽擛掖鐷葉谒謁曅
yi	義佁玴礒藙酏弈億笖瞖铱峄撎懿唈嫛佾誼嬄庡晹弌襼燡艤敡毅悒旖杙鄓绎轙彞鏔忔釔依貤遺郼以鷖袣逘瘗议坄谊渏怈廙勚槸驛枍旑籎异屹俋歝翊一奕悥臆匜浥彝沂鷁暆讉嶷嬑鳦疫宐宜欭簃蟻蛦抑焲螠尾頤媐翳乙棭浳衤栘缢医瀷饴侇浂蘙毉彛裔仡頉贀瑿肊译螘墿燚裿噫弬鹝咿冝湙鹢眙嬟膉苢輢呭瘱貽檍颐嶧椬鮧扅翼泆痍佚熼义憶兿蛇洢倚芅蓺埶豷圛帟攺荑蜴銥寲曎偯鷧狋蚁鎰瓵鈘繶邑怿艺易栧已亄鮨譯顗豛誃褹夁舣亿跇鯣齸鶂弋诣踦艗漪羛迱垼羿詍夷溢拸揖昳彜勩詒移悘繄阣秇澺敼痬羠宧鴺嶬訳逸豙乂竩猗贻椸訲釴亦蛾軼縊螔衣镱饐鷾苡萟鹥黓咦跠議怡稦熠賹禕殔穓隿崺飴讛癔虉貖枻萓醫沶鷊呓觺檥篒譩役钇呹耴艾姨食肄遗黳轶劓炈乁壹畩裛镒懌寱挹埸迆殹胰熪繹峓顊嗌齮鐿骮睪燱袘斁駅辷吚鉯衪潩扆獈矣迻殪帠仪迤蛜詣薏鶃匇鈠意儀忆刈恞巸翌壱疑異黟熤益蛡鸃杝圯劮訑珆曀伊幆檹伇榏醳囈醷驿桋诒謻頥藝苅瘞祎椅霬嫕
yin	訚朄檭濥因婣狺隐訔垠蚓铟櫽駰斦癊憖泿碒慭吟廴蒑霪荶濦絪陻垔印滛音諲烎隠溵凐裀飮猌赺珢粌犾栶荫骃鞇瘾檃檼緸龂銦氤禋崟崯筃懚隂趛吲龈嚚噖飲殷圁茵蔭侌誾夤湚婬峾癮磤廕姻秵鮣饮洇闉喑鈝岃尹鷣淾鈏瘖胤霠淫囙蔩陰茚殥酳齦璌阥訡银洕噾阴輑隱垽讔圻憗鄞蟫愔嶾慇銀堷寅窨乑冘引靷堙螾霒齗蘟韾
ying	鶯嬴英塋营濚嚶楹纓萤萦蝿螢鎣梬瓔荥瘿僌櫻璎籯媵绬瀯頴颕缨蠅褮韺浧鷹噟應贏縈桜鷪莺朠硬偀嬰甇撄甖暎应婴摬颍覮蓥廮映癭溋攍滢鐛罂盁鱦赢瑩瀛蝇罃瀴藀愥熒孾萾瀠灐瀅巊膡鹰荧禜鹦溁譻濴緓蘡嘤濙鑍媖樱颖灜鴬櫿郢籝蛍孆膺锳霙礯鸚影営煐鶧營罌蠳碤矨鶑嫈謍潁巆譍応蝧珱莹潆賏盈攖穎鸎渶迎瑛茔
yingli	哩
yo	育唷喲哟
yong	嫞顒踊臃鰫泳鲬鏞惥郺柡悀鷛壅佣雝擁恿噰癰愹庸嵱邕詠勈蒏牅傭鱅埇湧苚颙墉滽甬咏栐醟慵拥彮澭廱永俑塎鄘鳙痈蛹踴愑砽灉勇雍硧慂鯒怺涌用镛癕饔喁嗈
you	莜纋邮逌悠訧祐苃蚴丣幽猷羪怞鼬诱酭耰櫌迶肬遊栯滺魷卣呦宥瀀庮攸铀嚘游酉浟禉逰鱿釉銪又湵亴峳孧优柚友铕誘偤幼繇囿右佑黝泑憂駀鈾輏蝤優有鮋峟羑尤槱莸蝣楢貁猶油褎蜏姷沋侑牰牖怮聈梄鲉尢鄾蕕懮蚰由唀疣哊牗狖櫾郵麀怣輶忧甴莠秞犹
yu	于庾輿琙竽窳餘隃渝舆諛踰御罭軉灪铻楡懙閾迂潏玙榆域吁嵎预瑀麌籅雓堉蓣嫗峪魚宇俣鷸斞欤蘛戫菀穥邘圉袬龥喩鮽寓雤屿育慾騟欝箊硢嶼螸伛谕饇萭鬰媀俁驭钰遹譽汩狳蕍欲馭漁斔嶎稢燏霱緎覦鹬盂逳僪諭雨紆飫杅畬语語蜮籞酑艅醧矞蕷挧馀裕鱊禦焴蘌鄅亐逾鬱俞臾扵粥鴥銉娱与蓹玗龉惐崳輍鍝瘉窬璵與忬茰鷠郁鈺盓迃鬻余肀鹆腴蒮祤瘐萮圫轝薁伃陓芌獄澦予瑜礖寙蝓愚浴鴧魊聿頨唹衧喻歈稶楰雩谀髃俼鵒愈櫲敔歟喅虶預兪阈谷禺妤纡芋茟圄偊欥狱粖蜟娛砡鱼遇虞隅堬歶旟庽棫鐭彧鴪於込扜萸熨欎蔚噳誉羽隩錥嵛秗鋊淢楀鳿羭昱禹傴瘀渔鸆齵揄棜毓牏桙鸒匬儥饫湡玉鰅娯觎棛硲愉謣籲扝嬩燠礜堣篽睮骬尉淤齬煜癒爩驈穻滪悆貐淯豫礇舁菸喁澞褕
yuan	眢冤魭鸳嫄邧盶蜵援笎蝝惌剈芫駌鶰謜螈轅蚖湲圓縁葾爰垸薗蝯鋺榞溒黿垣愿圎櫞園蒬棩寃衏塬裷沅榬元渁员厵褤夗灁贠鼘員媴淵傆円杬院源涴瑗渆鼋遠鳶蒝裫鼝远願猨渊箢鴛鸢嬽囦蜎圜辕苑貟禐橼緣邍渕茒鎱褑媛园逺怨羱掾肙原妴鹓圆騵厡鵷袁猿噮缘鶢鈨
yue	戉岳岄泧軏瀹跀捳噦栎蚏篗钥抈悅矱籰钺阅鉞禴鸙粤哕閱蘥曱約恱曰籆爚约悦刖鈅月嶽玥礿乐蚎越閲嬳樾籥龠粵说躍箹鑰黦鸑妜跃
yun	橒縜蕴抣赟韗暈恽篔筼畇勻眃筠殞褞蘊妘耘賱允齳蒀囩孕夽運馧磒愠紜秐溳枟芸云员郧馻狁傊蕓涢伝鈗霣纭奫贇韫雲藴腪縕缊抎煴薀隕喗氲鋆蒕蝹韻醖愪匀惲耺熨荺鄆熅晕醞鄖殒氳澐齫酝沄韞郓蒷昀餫运韵阭熉慍陨
za	砸咋臢匝帀雜韴拶桚臜魳橴鉔沞雥雑沯囃扎囋杂襍咂
zai	縡儎扗载灾宰洅睵再烖栽仔載崽哉岾酨傤在溨災甾賳渽
zan	贊讚攅揝瓉赞讃鵤瓚攢濽篸鐕噆兂瓒趲拶撍儹襸鄼寁暫賛偺簪鏨昝趱簮橵儧喒禶錾鐟糌酇饡攒暂酂囋咱灒蹔
zang	藏匨臧牂賍塟脏弉髒欌奘銺羘蔵賘臓贜駔贓臟葬驵赃
zao	竃唣噪唕遭簉躁煰灶澡薻梍凿枣鑿栆慥喿璪蚤傮艁燥造趮棗蹧早竈藻醩皁譟皂糟
ze	沢泽咋則歵責皟謮諎瞔侧蔶嘖则齰滜賾泎蠌舴幘矠啧嫧擇赜啫鸅庂昗责溭襗仄笮汄択齚崱樍礋昃箦帻择捑迮簀
zei	鰂蠈賊鱡戝贼鲗
zen	譖谮怎
zeng	囎矰贈鋥罾繒综増缯曽憎鄫璔赠磳增锃譄熷甑曾橧鬵
zha	蜡咋箚鮺蚻札楂轧哳宱诈灹苲砟喳鮓喋譇抯炸鍘铡榨牐詐偧揸齇痄紥蚱咤拃譗皶眨闸鲝乍槎觰皻紮搾栅醡柞劄齄挓摣柤樝溠霅耫渣猹厏鲊查扎閘奓吒
zhai	粂侧檡债鉙債寨瘵斋夈责斎柴摘捚窄砦榸翟择祭齋宅
zhan	枬戰轏毡旃驏旜閚斬鱣虦魙展嶘战棧占崭驙榐惉鸇斩瞻饘覱趈沾詀搌嶦鳣飐襢绽盏颭噡飦譫讝嶃綻鹯盞佔氊橏輾站谵氈詹嫸栈譧薝霑粘戦虥桟蛅邅輚湛黵偡琖菚嶄醆蘸栴辗
zhang	痮獐暲仗蟑嶂鄣慞墇帳幛瞕扙蔁章长張鱆杖胀账脹帐丈涨掌张騿瘬粻彰礃障涱漳樟璋傽賬幥粀漲鏱遧嫜麞瘴仉餦
zhao	啁妱皽垗兆枛狣鮡肁罩赵笊棹爫找趙鼌旐詔巶朝櫂爪昭沼鍣诏鉊瑵炤照招箌駋召曌钊着嘲釗肇肈羄燳佋瞾
zhe	謫哲晣辙嚞者喆柘轍蟅蛰鮿讁晢籷蟄袩鹧厇折砓輙銸锗褚谪粍樜这這辄鍺鷓輒淛詟襵嫬磔矺浙啠螫摺謺蔗讋蜇遮着赭嗻歽褶悊踷埑虴
zhei	这
zhen	錱枕籈獉縝眞紖鎭砧軫嫃畛鱵誫姫絼貞贞縥禎幀楨鋴鍼臻揕针陣镇振帧溱眕屒挋樼纼箴紾碪駗眹祯弫薽疹瑧黰桢禛缜抮轸聄阵椹珎袗甄震賑甽偵診胗遉澵鸩搸珍潧稹侦鬒侲寊朕栚真湞诊蓁赈昣覙圳酙針辴蒖葴鎮殝鉁浈裖轃斟帪塦鴆榛
zheng	争证掙整佂蒸氶掟拯埩怔鲭聇崢糽踭挣铮鄭癥峥崝狰錚眐烝幁诤愸政姃脀鉦媜征丁炡諍證証筝篜揁鴊正靕晸症抍钲箏爭鬇鏳郑猙睜睁徰塣撜
zhi	騺徴泜樴姪骘锧稙稺儨扺茝炙雉櫛恉垁懫慹止至址傂廌躓置桎瘈祬狾縶輊汁蘵滞之掷秷鼅识黹旨膣窒伿稚潪梽瓡鳷禔秓禃跖吱懥帜枳趾祑咫洔志致質摭智聀蜘俧軄疷穉紩知騭豒彘戠膱襧擳鯯痓疻藢瀄质埴芖猘駤帙秩植劕躑執纸汥袠砋豸滍誌觶緻卮梔鑕殖制觯幟旘洷職织綕妷蹠劧痔鸷崻蟙璏值指扻铚衼畤馶栺搱瓆嬂搘偫汦椥栉擲峙坁夂寘豑抧筫栀直治倁臸氏淔疐鷙摨踯脂贽枝釞徏阯踬貭潌祗翐挃摯贄軹跱庢巵蹢絷忮剬执柣觗晊訨职肢榰娡痣漐衹礩紙製沚坧墌轾憄厔轵隲驇胝櫍隻支織墆螲乿鴲犆胑秖袟擿徵郅陟馽挚庤芝芷茋歭徝滯鴙迣覟帋鋕酯蛭只値侄淽銍祉熫
zhong	茽螤尰幒塚瘇籦衶祌汷蹱鐘鍾踵冢媑堹泈忠喠终煄種舯筗中锺肿仲偅衆歱蜙衷种銿妕盅蔠刣鈡蚛狆終炂螽钟柊腫彸妐众鼨忪重諥伀衳鴤徸眾
zhou	繇軸啁粙皺驟嚋咮伷皱賙荮酎葤盩纣籀鯞胄徟帚銂祝昼晝州辀烐舳绉冑珘婤籕僽謅咒疛噣週调霌肘鵃洲炿騆妯宙甃縐箒譸呪籒睭駎菷郮紂鸼淍舟喌輈輖诌晭粥矪骤侜诪轴周赒詋
zhu	祝躅舳属术褚助芧庶宁柚
zhua	簻爪抓髽挝膼撾檛
zhuai	拽转跩
zhuan	竱蒃篆磚灷撰篹塼赚沌僎瑑叀転专顓传襈諯瑼縳腞啭籑鱄转磗堟囀孨颛賺饌専鄟甎轉譔馔嫥蟤專砖膞
zhuang	壮莊庒庄戆樁壯粧裝妆僮状狀糚梉奘撞幢娤壵焋妝装桩湷荘
zhui	礈諈錣鑆墜隹赘醊沝笍甀畷腏縋娷坠锥椎惴綴贅鵻膇騅缒追錐硾缀骓
zhun	綧諄肫准窀衠啍迍屯谆準宒稕訰埻凖
zhuo	斲汋卓浊彴躅缴蠗篧蠿斫灼涿酌窧穛晫琢櫡斀槕桌硺诼濯炪镯擢穱罬窡棳鋜捉倬烵斮拙禚謶灂茁諑丵撯劅鐯斱娺諁鷟琸叕棁浞籱椓啄圴鵫鐲着焯妰擆濁啅斵梲籗犳
zi	胾孶稵緕纃渍榟蓻资姊錙葘姿虸紫茲栥鯔茊孖矷倳觜鰦資牸秄髭甾吱籽辎秭笫頾粢鄑嵫呰眦齍漬仔镃姉杍芓荢鶅紎谘姕兹吇字自孳菑梓恣椔耔锱啙龇訿滋胔咨澬淄貲頿缁鎡輺胏鈭剚滓眥赼禌崰湽茈趑鍿赀趦玆孜訾齜子嗭諮秶鲻釨緇輜嗞茡鼒
zong	揔鯼瘲緵緫猔宗骔繌综疭椶朡総磫鯮踪縂惣綜翪堫燪豵嵕总縱枞緃蹤傯惾捴潈稯蝬鍐鬉蓗碂昮踨纵騣棕腙鬷猣熧葼鬃倧嵸倊搃焧糭總騌縦嵏偬粽摠鑁糉
zou	奏騶走箃緅驺掫黀齺陬诹菆齱鲰棸棷邹赱諏揍鄒郰鯫鄹
zu	椊足诅哫族唨崒租崪卒苴爼蒩葅踤镞菹卆珇鏃箤俎詛阻靻组組祖
zuan	钻纉劗攥鑽篹纂赚鑚缵躜籫纘繤鉆躦
zui	檌鋷璻厜樶蕞檇纗嶊噿咀醉冣嶵絊蟕晬最酻嗺觜槜稡脧祽嘴栬辠錊酔罪
zun	撙鱒譐捘繜噂鐏罇尊嶟樽遵銌僔鳟鷷
zuo	筰做繓唑稓琢嘬作侳怍鈼坐岝穝捽佐阼糳笮座撮祚咗左昨秨胙飵岞莋葄葃袏
